ability	(n)	 Năng lực, khả năng
able 	(a)	 Có năng lực, có khả năng
able 	(a)	 Thích hợp
ably 	(adv)	 Một cách có tài
abrupt 	(a)	 Thình lình , đột ngột
abruptly 	(adv)	 Thình lình, rời ra
abruptness 	(n)	 Sự bất ngờ
absence 	(n)	 Sự vắng mặt
absent 	(a)	 Vắng mặt
absentee 	(n)	 Người vắng mặt
absently 	(adv)	 Lơ đãng
academe 	(n)	 Học viện, trường đại học
academicals 	(n)	 Mũ và áo dài mặc ở đại học
academician 	(n)	 Viện sĩ
academie 	(a)	 Thuộc về trường đại học
academy 	(n)	 Viện hàn lâm, viện triết học
access 	(n)	 Lối vào, đường vào, đến gần
access 	(v)	 Truy cập
accessibility 	(n)	 Sự có thể đến gần
accessible 	(a)	 Có thể đi vào, tới gần
accession 	(n)	 Gia nhập và
accommodate 	(v)	 Cung cấp tiện nghi, chỗ ở
accommodating 	(a)	 Hay giúp đỡ, thuận lợi
accommodation 	(n)	 Chỗ trọ, chỗ ở, tiện nghi
accord 	(n	 Đồng tình . đồng lòng
accordance 	(n)	 Giống nhau , hợp nhau
accordant 	(a)	 Phù hợp
according	(pre)	 Tùy theo
accordingly 	(adv)	 Thùy theo
accustom 	(v)	 Làm quen
accustomed 	(a)	 Quen
achievable 	(a)	 Có thể hoàn thành, đạt được
achieve 	(v)	 Có được, đạt được
achiever 	(n)	 Người thành đạt
achivement 	(n)	 Thành tụu, thành tích
acquaint 	(v)	 Làm quen, hieu biết
acquaintance 	(n)	 Sự làm quen , hiểu biết ,
act 	(v)	 Thực hiện
action 	(n)	 Hành đọng
active 	(a	 Tích cực
activist 	(n)	 Người họat động tích cực
activity 	(n)	 Sự hoạt động
actor 	(n)	 Nam diễn viên
actress 	(n)	 Nữ diễn viên
acttractively 	(adv)	 Thật phấp dẫn
actual 	(a)	 Thật sự, quả thật
actually 	(adv)	 Quả thật, thật ra
addict 	(n)	 Người nghiện, người say mê
addicted 	(a)	 Say mê, nghiện
addiction 	(n)	 Thói nghiện, sự ham mê
admire 	(v)	 Ngưỡng mộ, hâm mộ
admirer 	(n)	 Người ái mộ
advantage 	(n)	 Sự thuận lợi
advantageous 	(a)	 Có lợi, thuận lợi
adventure 	(n)	 Cuộc phiêu lưu
adventurer 	(n)	 Người thích mạo hiểm
adventurous 	(a)	 Thích mạo hiểm
advertise 	(v)	 Quảng cáo
advertisement 	(n)	 Mục quảng cáo
advertiser 	(n)	 Người nhà quảng cáo
advertising 	(n)	 Sự ảung cáo
advice 	(n)	 Lời khuyên
advisability 	(n)	 Sự khen ngợi
advisable 	(a)	 Nên khôn ngoan
advise 	(v)	 Khuyên ảo
advisedly 	(adv)	 Thận trọng, suy nghĩ kỹ
adviser 	(n)	 Người chỉ bảo, cố vẫn
adviser 	(n)	 Người khuyên, cố vấn
advisory 	(a)	 Cho ý kiến
affect 	(n)	 Cảm gáic, ham muốn
affect 	(v)	 ảnh hưởng đến, bổ nhiệm
affectation 	(n)	 Không thành thật, bổ nhiệm
affected 	(a)	 Được bổ nhiệm, cảm động
affection 	(n)	 ảnh hưởng, cảm động
affective 	(a)	 Dễ cảm động, đa cảm
affectively 	(adv)	 Thật đa cảm
age 	(n)	 Tuổi
aggress 	(v)	 Gây hấn, gây cự
aggression 	(n)	 Sự tấn công , xâm lược
aggressive 	(a)	 Hiếu chiến, xâm lăng
aggressively 	(adv)	  cách hiếu chiến
aggressor 	(n)	 Kẻ xâm lược
agree 	(v)	 Đồng ý
agreeable 	(a)	 Sẵn sàng đồng ý
agreeably 	(adv)	  cách tán thành
agreement 	(n)	 Sự đồng ý
agricultural 	(a)	 Thuộc về nông nhiệp
agriculture 	(n)	 Nông nghiệp
agriculturist 	(n)	 Người làm ruộng
alarm 	(n)	 Sự báo đọng sự sợ hãi
alarm 	(v)	 Báo động
alarmed 	(a)	 Lo lắng, sỡ hãi
alarming 	(a)	 Làm cho lo lắng sợ
alarmism 	(n)	 Sự gieo hoang mang
alarmist 	(n)	 Người dễ sợ hai
alert 	(a)	 Mau, nhanh lẹ
alert 	(v	 Báo động sự báo động
alertness 	(n)	 Sự mau mắn
alter 	(v)	 Thay đổi
alterability 	(n)	 Sự thay đổi
alterable 	(a)	 Có thể thay đổi
alteration 	(n)	 Sự thay đổi
alternate 	(v	 Thay thế, luân phiên
alternately 	(adv)	 Lần lượt, thay phiên
alternating 	(a)	 Thay phiên , xoay chiều
alternation 	(n)	 Sự luân phiên, tuần hoàn
alternative 	(a)	 Luân phiên
alternatively 	(adv)	 Cách luân phiên, chọn lựa
amaze 	(v)	 Làm ngạc nhiên
amazed 	(a)	 Bị làm ngạc nhiên
amazedly 	(adv)	 Thật đáng ngạc nhiên
amazement 	(n)	 Sự ngạc nhiên
amazing 	(a)	 Ngạc nhiên
amazingly 	(adv)	 Thật ngạc nhiên
ambition 	(n)	 Hoài bão
ambitious 	(a)	 Có hoài bão
ambitiously 	(adv)	 Thật nhiều hoài bão
america 	(n)	 Châu Mỹ , nước Mỹ
american 	(a)	 Thuộc về Châu Mỹ
american 	(n)	 Người Mỹ
amirable 	(a)	 Đáng hâm mộ
amiration 	(n)	 Sự hâm mộ
amuse 	(v)	 Làm cho vui
amused 	(a)	 Bị làm cho vui
amusedly 	(adv)	 Thật vui
amusement 	(n)	 Sự vui nhộn
amusing 	(a)	 Vui
amusingly 	(adv)	 Thật vui
ancient 	(a)	 Xưa, cổ xưa
anciently 	(adv)	 Thật, xa xưa
ancientness 	(n)	 Tính trạng cổ xưa
anger 	(v	 Chọc giận, sự giận dữ
angrily 	(adv)	 Một cách giận dữ
angry 	(n)	 Giận dữ
announce 	(v)	 Tuyên bố, thông báo tin
announcer 	(n)	 Người tuyên bố, phát ngôn
annoy 	(v)	 Làm phiền, quấy rấy
annoyance 	(n)	 Sự làm phiền
annoyed 	(a)	 Bị làm phiền
annoying 	(n)	 Buồn bực
anouncement 	(n)	 Sự tuyên bố, thông báo
apologist 	(n)	 Người xin lỗi
apologize 	(v)	 Xin lỗi
apology 	(n)	 Sự xin lỗi
applaud 	(v)	 Vỗ tay, khen ngợi
applauder 	(n)	 Người hay khen , tán thành
applause 	(n)	 Sự tán thành, biểu dương
appliance 	(n)	 Thiết bị, dụng cụ, ứng dụ
applicable 	(a)	 Có thể dùng được
applicably 	(adv)	 Áp dụng được
applicant 	(n)	 Người xin việc
application 	(n)	 Sự áp dụng
apply 	(v)	 ứng dụng, áp dụng
appoint 	(v)	 Hẹn
appointed 	(a)	 Đính hẹn
appointment 	(n)	 Cuộc hẹn
approximate 	(a	 Gây ước chừng, xấp xỉ
approximately 	(adv)	 Vào khoảng, gần
approximation 	(n)	 Sự gần giống nhau
argue 	(v)	 Biện luận, tranh luận
argument 	(n)	 Lý lẽ, sự tranh luận
argumentation 	(a)	 Sự cãi, biện luận, luận chứng
argumentative 	(a)	 Hợp với lí luận, hay lý luận
arrange 	(v)	 Sắp xếp
arrangement 	(n)	 Sự xếp đặt
arrival 	(n)	 Sự đến, tới
arrive 	(v)	 Đến
arrivist 	(n)	 Người mới phất
art 	(n)	 Nghệ thuật, mỹ thuật
artist 	(n)	 Họa sĩ
artistic 	(a)	 Có mỹ thuật
artistically 	(adv)	 Thật có tính mỹ thuật
artless 	(a)	 Không có mỹ thuật
artlessly 	(adv)	 Thật không có mỹ thuật
artlessness 	(n)	 Sự không có mỹ thuật
assign 	(v)	 Phân công, giao nhiệm vụ
assigner 	(n)	 Người phân công
assignment 	(n)	 Sự phân công, việc được
assist 	(v)	 Giúp đỡ, trợ lực
assistance 	(n)	 Sự giúp đỡ , trợ lực
assistant 	(a)	 Giúp việc, phụ tá
assistant 	(n)	 Người phụ tá bán hàng
assistantship 	(n)	 Chức phó, phụ , trọ
associability 	(n)	 Có khả năng liên kết được
associable 	(a)	 Có thể liên kết đươc
associate 	(v)	 Phối hợp, liên kết
association 	(n)	 Sự phối hợp, liên kết
associational 	(a)	 Liên quan đến hội đoàn
associative 	(a)	 Thuộc về sự niên hợp
attend 	(v)	 Chú ý , chăm sóc
attend 	(v)	 Tham dự, có mặt , hầu hạ
attendance 	(n)	 Sự tham dự, có mặt , hầu hạ
attendant 	(n)	 Người hầu cho người có quyền
attention 	(n)	 Sự chú ý, lưu ý
attentive 	(a)	 Chú ý, lưu ý
attentively 	(adv)	  cách lưu ý
attentiveness 	(n)	 Sự chú ý
attract 	(v)	 Thu hút
attraction 	(n)	 Sự thu hút
attractive 	(a)	 Thu hút, hấp dẫn
australia 	(n)	 Châu Úc , nước Úc
australian 	(a)	 Thuộc về nước Úc
australian 	(n)	 Người Úc
austria 	(n)	 Nước Áo
austrian 	(a)	 Thuộc về nước Áo
austrian 	(n)	 Người Áo
author 	(n)	 Nam tác giả
authoress 	(n)	 Nữ tác giả
authorial 	(a)	 Thuộc về quyền tác giả
authoritative 	(a)	 Có quyền lực, thẩm quyền
authoritatively 	(adv)	 Có vẻ quyền hành
authority 	(n)	 Nhà cầm quyền
authorization 	(n)	 Sự cho phép, giấy ủy quyền
authorize 	(v)	 Cho phép, ban quyền
authorship 	(n)	 Nghề viết văn
automatic 	(a)	 Tự động ,máy móc
automatic 	(v)	 Tự động hóa
automatically 	(adv)	 Một cách tự động
automatics 	(n)	 Tự động học
automation 	(n)	 Sự tự động hóa
availability 	(n)	 Sự có hiệu lực
available 	(a)	 Có hiệu lực, có giá trị
availably 	(adv)	 Thật có giá trị
avoid 	(v)	 Tránh né
avoidable 	(a)	 Tránh xa
avoidance 	(n)	 Sự tránh né
aware 	(a)	 Nhận thức , nhận thấy
awareness 	(n)	 Sự nhận thức
awful 	(a)	 Hình sự, khủng khiếp
awfully 	(adv)	 Thật khủng khiếp
awfulness 	(n)	 Sự kinh sợ B
bad 	(a)	 Xấu tệ, dở
badly 	(adv)	 Thật là tệ
badness 	(n)	 Sự xấu
bagginess 	(n)	 Sự rộng thùng thình
baggy 	(a)	 Rộng thùng thình
bald 	(a)	 Khô khan
balding 	(a)	 Bắt đầu hói
baldly 	(adv)	 Nghèo nàn, khô khan
baldness 	(n)	 Chứng rụng tó, hói
beautician 	(n)	 Chuyên viên thẩm mỹ
beautiful 	(a)	 Đẹp , xinh đẹp
beautifully 	(adv)	 Thật xinh đẹp
beautify 	(v)	 Làm đẹp
beauty 	(n)	 Vẻ đẹp
begin 	(v)	 Bắt đầu
beginner 	(n)	 Người bắt đầu
beginning 	(n)	 Lúc đầu
behave 	(v)	 Ăn ở, cư xử
behaved 	(a)	 Có lễ phép, đứng đắn
behavior 	(n)	 Cách cư xử, thái độ
behavioral 	(a)	 Thuộc về cư xử
beneficial 	(a)	 Có lợi ch
benefit 	(n)	 Lợi ích, ân huệ, phụ cấp
benefit 	(v)	 Được lợi, lợi dụng
better 	(a)	 Tốt hơn
big 	(a)	 To
bigly 	(adv)	 Thật to
bigness 	(n)	 Sự to lớ
biological 	(a)	 Thuộc vè sinh vật học
biologically 	(adv)	 Về mặt sinh học
biologist 	(n)	 Nhà sinh vật học
biology 	(n)	 Sinh vật học
birth 	(n)	 Sự sinh đẻ
birthday 	(n)	 Ngày sinh
blind 	(a)	 Đui, mù
blinding 	(a	 Chói mắt. tật mù
blindly 	(adv)	  cách mù quáng
blindness 	(n)	 Sự mù lòa
board 	(v)	 Lên tàu, lót ván
boarder 	(n)	 Kẻ chiếm tàu, sinh viên nội trú
boarding 	(n)	 Sự lót ván
boardwages 	(n)	 Tiền cơm, phụ cấp
bore 	(v)	 Buồn chán
bored 	(a)	 Bị làm cho buồn
boredly 	(adv)	 Bị làm cho buồn
boredom 	(a)	 Sự buồn chán
boring 	(a)	 Buồn, chán
boringly 	(adv)	 Thật buồn
botanical 	(a)	 Thuộc về thảo mộc
botanist 	(n)	 Nhà thực vật học
botanize 	(v)	 Nghiên cứu thực vật
botany 	(n)	 Thực vật học
brave 	(adv)	 Bất chấp, không sợ
brave 	(v)	 Can đảm
bravely 	(adv)	 Dũng cảm
braveness 	(n)	 Sự dũng cảm, tính gan dạ
bright 	(a)	 Sáng chói
brightly 	(adv)	 Thật sáng chói
brightness 	(n)	 Sự rực rỡ
brilliance 	(n)	 Sự xuất chúng, tài giỏi
brilliant 	(a)	 Tài năng, xuất sắc
brilliantly 	(adv)	 Một cách tài giỏi
brother 	(n)	 Anh em trai
brotherhood 	(n)	 Tình huynh đệ
brotherly 	(n)	 Thuộc về anh em
buddha 	(n)	 Phật Thích Ca
buddhism 	(n	
buddhist 	(n)	 Người theo đạo Phật
buddhist 	(n)	 Thuộc về đạo Phật
build 	(v)	 Xây dựng
builder 	(n)	 Người xây dựng, thầu
building 	(n)	 Sự xây dựng, tòa nhà
bullon 	(n	 Cài nút
burn 	(n)	 Vết bỏng, cháy
burn 	(v)	 Đốt cháy, thiêu hủy
burner 	(n)	 Người đốt
burning 	(a)	 Đang cháy , nóng bỏng
bush 	(n)	 Bụi cây
bushy 	(a)	 Có bụi cây
busily 	(adv)	 Thật bận rộn
business 	(n)	 Việc mua bán, kinh doanh
businesslike 	(a)	 Có hiệu quả, hệ thống
businessman 	(a)	 Doanh nhân
busy 	(a)	 Bận rộn, đông đúc
calculate 	(v)	 Tính toán
calculating 	(a)	 Thận trọng ,có tính toán
calculation 	(n)	 Sự tính toán
calculative 	(n)	 Có tính toán
calculator 	(n)	 Máy tính , người tính
can 	(n	 Bình can, hộp, đóng hộp
canada 	(n)	 Người Canada
canada 	(n)	 Nước Canada
canadian 	(a)	 Thuộc Canado. Tiếng Canada
canful 	(n)	 Đầy bình
canned 	(a)	 Được vô hộp
care 	(n)	 Sự chăm sóc, chăm nom
careful 	(a)	 Cẩn thận
carefully 	(adv)	 Thật cẩn thận
carefulness 	(n)	 Sự thận trọng
careless 	(a)	 Bất cẩn
carelessly 	(adv)	 Thật bất cẩn
carelessness 	(n)	 Sự bất cẩn
carriage 	(n)	 Cách cư xử, thái độ, thực
carry 	(v)	 Mang, vác, chuyên chở, cư xử
casual 	(a)	 Tình cờ, thất thường
casually 	(adv)	 Tình cờ
casualty 	(n)	 Bất thường
celebrant 	(n)	 Người coi việc cúng tế
celebrate 	(v)	 Tổ chức lễ
celebration 	(n)	 Lễ kỉ niệm
center 	(n)	 Trung tâm
central 	(a)	 Tại trung tâm, quan trọng
centralize 	(v)	 Tập trung
centrally 	(a)	 Thật trọng tâm
certain 	(a)	 Chắc chắn
certainly 	(adv)	 Thật chắc chắn
certainty 	(n)	 Sự chắc chắn
challenge 	(v)	 Thách thức, tháhc đố
challenger 	(n)	 Người thách đấu
challenging 	(a)	 Thử thách, kích thích
champion 	(n)	 Nhà vô địch
championship 	(n)	 Chức vô địch
change 	(n)	 Sự thay đổi
change 	(v)	 Thay đổi
changeable 	(a)	 Có thể thay đổi
changeful 	(a)	 Hay thay đổi
changeless 	(a)	 Không thể thay đổi
charitable 	(a)	 Từ thiện bác ái khoan dung
charitableness 	(n)	 Lògn từ thiện, nhân đức
charity 	(n)	 Từ thiện, lòng bác ái
cheap 	(a)	 Rẻ tiền
cheapen 	(v)	 Hạ giá
cheaply 	(adv)	 Thật rẻ
cheapness 	(n)	 Giá rẻ
cheer 	(v	 Hoan hô, reo vui
cheerful 	(a)	 Vui ve, hân hoan
cheerfully 	(adv)	 Thật vui vẻ
cheerfulness 	(n)	 Sự vui vẻ, hân hoan
chemer 	(a)	 Người thảo kế hoạch
chemical 	(a)	 Thuộc về hóa học
chemically 	(adv)	 Về hương diện hóa học
chemicals 	(n)	 Hóa chất
cheming 	(a)	 Chương trình , kế hoạch
chemist 	(n)	 Nhà hóa học
chemistry 	(n)	 Ngành hóa học
chief 	(a	 Chủ yếu, chính yếu
chiefly 	(adv)	 Trên hết, cốt yếu
child 	(n)	 Trẻ con,  đứa trẻ
childhood 	(n)	 Thời nien thiếu
childish 	(n)	 Như co nít
children 	(n)	 Trẻ con, nhiều dứa trẻ
china 	(n)	 Nước Trung Quốc
chinese 	(n	 Người Trung Quốc, tiếng
choice 	(n)	 Sự chọn lựa
choose 	(v)	 Chọn lựa
chossy 	(a)	 Hay kén chọn
citizen 	(n)	 Công dân thành phó
citizenship 	(n)	 Quyền công dân
claim 	(v	 Tuyên bố, yêu cầu
claimant 	(a)	 Có thể yêu cầu
claimer 	(n)	 Người thỉnh cầu, nguyên cáo
class 	(n)	 Lớp học
classic 	(a)	 Cổ điển
classical 	(n)	 Nhạc cổ điển
classify 	(v)	 Xếp hạng, xếp loại
classmate 	(n)	 Bạn cùng lớp
classy 	(a)	 Hạng tốt
clean 	(a)	 Sạch sẽ
clean 	(v)	 Lau chùi, làm sạch
cleanable 	(n)	 Có thể lau chùi
cleaner 	(n)	 Người làm sạch
cleanliness 	(n)	 Tính sạch sẽ, sự trong sạch
clear 	(n)	 Rõ ràng, sáng sủa
clear 	(v)	 Làm cho sáng
clearly 	(adv)	 Thật rõ ràng
clearness 	(n)	 Sự minh bạch, rõ ràng
clenaly 	(adv)	 Thật sạch sẽ
clever 	(a)	 Khéo léo
cleverly 	(adv)	 Thật khéo léo
cleverness 	(n)	 Sự khéo léo
climb 	(v	 Leo trèo , sự leo trèo
climbable 	(a)	 Có thể leo được
climber 	(n)	 Người leo núi
close 	(a)	 Gần gũi, thân cận
close 	(v)	 Đóng, ngăn chặn
closely 	(adv)	 Thật gần gũi
closeness 	(n)	 Sự gần gũi
cloth 	(n)	 Vải ,khăn bàn
clothe 	(v)	 Mặc đồ, may cho
clothes 	(n)	 Quần áo, y phục
clothier 	(n)	 Người dệt vải, bán quần áo
clothing 	(n)	 Sự mặc đồ, y phục
cloud 	(n)	 Mây
cloudy≠cloudless 	(a)	 Có mây, Không có mây
co- operative 	operative	 Có tính cộng tác
co- operator 	operator	 Người cộng tác
coast 	(n)	 Bờ biển duyên hải
coast 	(v)	 Đi dọc theo bời biển
coastal 	(a)	 Thuộc miền duyên hải
coaster 	(n)	 Tàu buồn chạy ven biển
coastline 	(n)	 Miền duyên hải
coastward 	(adv)	 Hướng về bờ biển
coat 	(v	 Áo choàng bọc ngoài
coated 	(a)	 Có bọc ngoài, che
coating 	(n)	 Lớp phủ ngoài
co-educate 	(v)	 Giáo dục tổng hợp nam nữ
co-education 	(n)	 Nền giáo dục tổng hợp
co-educational 	(a)	 Thuộc về giáo dục nam nữ
cold 	(a)	 Lạnh lẽo
coldish 	(a)	 Hơi lạnh
coldly 	(adv)	 Thật lạnh lẽo
coldness 	(n)	 Sự lạnh lẽo
collapsible 	(a)	 Có thể xếp lại, thu lại
collect 	(v)	 Thu gom sưu tầm
collection 	(n)	 Sự thu gom, bộ sưu tầm
collective 	(a)	 Tập thể
collector 	(n)	 Người thu gom, sưu tầm
colllapse 	(v)	 Đổ sập, ngã quỵ, xếp gọn
color 	(n)	 Màu sắc
colorant 	(n	 Thuốc màu, thuốc nhuộm
colored 	(a)	 Đã có sẵn màu
colorful 	(a)	 Có nhiều màu
colorist 	(n)	 Người tô màu
comedian 	(n)	 Diễn viên hài
comedienne 	(n)	 Nữ diên viên hài
comedy 	(n)	 Kịch vui, hài kịch
comfort 	(n	 Sự an ủi
comfort 	(v)	 An ủi, làm khuây
comfortable 	(a)	 Thoải mái, dễ chịu
comfortably 	(adv)	 Thật dễ chịu
comic 	(a)	 Hài hước, khôi hài
comic 	(n)	 Diễn viên hài
comical 	(a)	 Khôi hài, tức cười
comically 	(adv)	 Thật tức cười
commerce 	(n)	 Thương mại
commercial 	(a)	 Thuộc về thương mại
commercially 	(adv)	 Về phương diện thương mại
common 	(a)	 Chung ,công
commonly 	(adv)	 Thông thường, bình thường
commonness 	(n)	 Tính chất chung chung
communal 	(a)	 Thuộc công cộng, của chung
communalize 	(v)	 Biến thành của chung
commune 	(v)	 Hòa mình , sống thân mật
communication 	(n)	 Sự thông tin liên lạc
communicative 	(a)	 Sẵn sàng thông tin
communicatively 	(adv)	 Thông tin được truyền đi
communicator 	(n)	 Người truyền tin, máy truyền tin
communist 	(n)	 Người cộng sản
community 	(n)	 Nhân dân, công đồng
communize 	(v)	 Cộng sản hóa
comparable 	(a)	 Có thể so sánh
comparably 	(adv)	 So sánh được
comparative 	(a)	 So sánh, tương đối
comparatively 	(adv)	 Tương đối
compare 	(v)	 So sánh
comparison 	(n)	 Sự so sánh
compel 	(v)	 Ép buộc
compete 	(v)	 Tranh tài, thi đấu
competition 	(n)	 Cuộc tranh tài
competitive 	(a)	 Có tính tranh tài
competitively 	(adv)	 Thật cạnh tranh
competitor 	(n)	 Người tranh tài
compilation 	(n)	 Sự biên tập, thu lượm
compile 	(v)	 Biên tập, biên soạn
compiler 	(n)	 Người biên soạn
complain 	(v)	 Than phiền
complainant 	(n)	 Người thực hiện
complainer 	(n)	 Người than phiền
complainingly 	(adv)	 Oán trách, ca thán
complaint 	(n)	 Lời than phiền
complet 	(a)	 Đầy đủ trọn vẹn
complete 	(v)	 Hoàn thành
completely 	(adv)	 Một cách hoàn thành
completeness 	(n)	 Tính chất trọn vẹn
completion 	(n)	 Sự hoàn thành
complex 	(a	 Phức tạp , phiền phức, rắc
complexity 	(n)	 Sự rắc rối
complicate 	(v)	 Làm phức tạp , rắc rối
complicated 	(a)	 Phức tạp, rắc rối
complication 	(n)	 Sự phức tạp, rắc rối
compliment 	(v	 Khen ngợi
complimentary 	(a)	 Tán dương, khen ngợi
compose 	(v)	 Soạn , sáng tác
composer 	(n)	 Người soạn nhạc
composing 	(n)	 Sự sáng tác
composition 	(n)	 Bài sáng tác, bài luận
compulsion 	(n)	 Sự bắt buộc
compulsory 	(a)	 Bắt buộc, cưỡng chế
computable 	(a)	 Có thể tín toán được
computation 	(n)	 Sự tính toán ước lượng
computational 	(a)	 Sử dụng máy điện toán
compute 	(v)	 Tính toán
computer 	(n)	 Máy tính
computerize 	(v)	 Diện toán hóa
condition 	(n)	 Điều kiện, hoàn cảnh
conditional 	(a)	 Có điều kiện
conditionally 	(adv)	 Tùy theo điều kiện
conditioned 	(a)	 Điều hòa, có điều kiện
conditioner 	(n)	 Máy điều hòa
conduct 	(v)	 Dẫn dắt, dẫn nhiệt
conduction 	(n)	 Sự dẫn, truyền nhiệt
conductive 	(a)	 Có tính truyền dẫn nhiệt
conductivity 	(n)	 Tính truyền dẫn nhiệt ,điện
conductor 	(n)	 Người bán vé, vật đánh điện
conductress 	(n)	 Nữ bán vé xe
confidence 	(n)	 Sự tin cậy
confident 	(a)	 Tin chắc, tin cậy
confidential 	(a)	 Kín, bí mật, được tín nhiệm
confidently 	(adv)	 Tự tin
congratulate 	(v)	 Chúc mừng
congratulation 	(n)	 Sự chúc mừng
congratulator 	(n)	 Người chúc mừng
congratulatory 	(a)	 Khen ngợi, khen tặng
connect 	(v)	 Kết nối
connected 	(a)	 Có quan hệ, liên thông
connection 	(n)	 Sự liên kết
connective 	(a)	 Dùng để liên lạc
connector 	(n)	 Chỗ liên kết
conscious 	(a)	 Hiểu biết, tỉnh táo
consciously 	(adv)	 Có ý thức, cố ý
consciousness 	(n)	 Sự hồi tỉnh, có ý thức
conservation 	(n)	 Sự bảo tồn , bảo quản
conservationist 	(n)	 Người bảo quản
conservative 	(a)	 Bảo thủ, bảo tồn
conservator 	(n)	 Ngươi bảo vè, trồng trọt
conserve 	(v)	 Gìn giữ, bảo tồn
consider 	(v)	 Xem xét, suy nghĩ đắn đo
considerate 	(n)	 Ý tứ, thận trọng
considerately 	(adv)	 Thật thận trọng
consideration 	(n)	 Sự suy xét kỹ , thận trọng
construct 	(v)	 Làm xây dựng
construction 	(n)	 Sự xây dựng
constructive 	(a)	 Thộc về xây dựng
constructively 	(adv)	 Có tính cách xây dựng
constructor 	(n)	 Kiến trúc sư
consumable 	(a)	 Có thể ăn được
consume 	(v)	 Tiêu thụ
consumer 	(n)	 Người tiêu dùng
consuming 	(a)	 Tiêu hủy
consumption 	(n)	 Sự tiêu thụ, tiêu dùng
consumptive 	(a)	 Thuộc về sự tiêu thụ
contact 	(n)	 Sự giao dịch , liên lạc
contact 	(v)	 Tiếp xúc, đụng chạm
contactor 	(n)	 cái ngắt điện tự động
contaminant 	(n)	 Đồ dựng, công tai nơ
contaminate 	(v)	 Chứa đựng, bao gồm
contamination 	(n)	 Có thể nén lại
contest 	(n)	 Sự nhiễm bẩn
contest 	(v)	 Nhiễm bẩn
contestable 	(a)	 Tranh tài, thi đấu
contestant 	(n)	 Chất gây nhiễm bẩn
contestation 	(n)	 Cuộc tranh tài
continuation 	(n)	 Sự tiếp tục, liên tục
continuator 	(n)	 Người làm tiếp
continue 	(v)	 Làm tiếp, tiếp tục
continuous 	(a)	 Tiếp tục, liên tiếp
continuousness 	(n)	 Sự tiếp tục
control 	(n)	 Sự diều khiển, kiểm soát
control 	(v)	 Điều khiển, kiểm soát
controllable 	(a)	 Có thể kiểm sáot được
controller 	(n)	 Nhân viên, máy kiểm soát
convenience 	(n)	 Sự tiện lợi
convenient 	(a)	 Thuận lợi
conveniently 	(adv	 Thật thuận lợi
cook 	(n)	 Đầu bếp
cook 	(v)	 Nấu ăn
cooker 	(n)	 Bếp lò
cookery 	(n)	 Nghề nấu ăn
cookie 	(n)	 Bánh ngọt
cooking 	(n)	 Cách nấu ăn
cool 	(a)	 Mát lạnh
cool 	(v)	 Làm mát
cooler 	(n)	 Máy ướp lạnh
coolly 	(adv)	 Mát mẻ, điềm tĩnh
coolness 	(n)	 Sự lạnh lùng
cooolant 	(n)	 Chất lỏng làm nguội
co-operate 	(v)	 Hợp tác,chung sức
co-operation 	(n)	 Sự cộng tác
correct 	(a	 Đúng, sửa cho đúng
correction 	(n)	 Sự sữa chữa
corrective 	(a)	 Dễ sửa chữa
correctively 	(adv)	 Dễ hiệu chỉnh
correctly 	(adv)	 Thật chính xác
correctness 	(n)	 Sự chính xác
corrector 	(n)	 Người sữa chữa
correspond 	(v)	 Tương xứng
correspondence 	(n)	 Sự giao dịch, tương hợp
correspondent 	(a)	 Tương đối với
correspondent 	(to)	 (n) Phóng viên, thông tín viên
corresponding 	(a)	 Bằng nhau, thông tin
correspondingly 	(adv)	 Một cách tương xứng
cost 	(n)	 Giá mua
cost 	(v)	 Đáng giá, tốn tiền
costless 	(a)	 Không tốn tiền
costly 	(a)	 Tốn tiền, đắc giá
council 	(n)	 Hội đồng, ủy ban, hội nghị
councillman 	(n)	 Hội viên, hội đồng
councillor 	(n)	 Nghị viên
councillorship 	(n)	 Chức nghị sự
count 	(n)	 Tổng số
count 	(v)	 Đếm
countable 	(a)	 Có thể đếm được
countably 	(adv)	 Đếm được
counter 	(n)	 Máy đếm, quầy thu tiền
countless 	(a)	 Không đếm được, vô số kể
courage 	(n)	 Sự can đảm dũng cảm
courageous 	(a)	 Can đảm , dũng cảm
create 	(v)	 Tạo, sáng tác
creation 	(n)	 Sự sáng tạo
creative 	(a)	 Sáng tạo
creatively 	(adv)	 Thật sáng tạo
creativeness 	(n)	 Óc sáng tạo
creator 	(n)	 Người sáng tạ
creature 	(n)	 Tạo vật, loài người, loài vật
crier 	(n)	 Người rao bán
crowd 	(n)	 Đám đông
crowd 	(v)	 Tụ tập, làm cho đông
crowded 	(a)	 Đông đúc
cruel 	(a)	 Hung dữ, độc ác
cruelly 	(adv)	 Thật tàn nhẫn
cruelty 	(n)	 Sự tàn nhẫn, hung dữ
cry 	(v)	 Khóc , la
crying 	(a)	 Khóc lóc, kêu la
cultural 	(a)	 Thuộc về văn hóa
culturally 	(adv)	 Vè phươgn diện văn hóa
culture 	(n)	 Văn óa
cultured 	(n)	 Có văn hóa, học thức
curl 	(v	 Uốn , quăn , làm gợn sóng,
curler 	(n)	 ống uốn toác
curliness 	(n)	 Tíh quăn, tính xoắn
curly 	(a)	 Quăn, xoắn, uốn
custom 	(n)	 Phong tục, thói quen
customar 	(n)	 Người mua, khách mua
customary 	(a)	 Thành thói quen
customize 	(v)	 Làm thay đổi đồ theo ý
cyclonal 	(n)	 Thuộc về gió cuốn D
cyclone 	(n)	 Cơn gió lốc, bão
daily 	(a	 Mỗi ngày, hàng ngài
damage 	(n)	 Sự tổn hại
damage 	(v)	 Làm thiệt hại
damageable 	(a)	 Có hại
damaging 	(a)	 Sự nguy hiểm
danger 	(n)	 Sự nguy hiểm
dangerous 	(a)	 Nguy hiểm
dangerously 	(adv)	 Thật nguy hiểm
dark 	(a	 Bóng tối , sẫm màu
darken 	(v)	 Làm cho tối lại
darkness 	(n)	 Sự tối tăm , bóng tối
day 	(n)	 Ngày
deaf 	(a)	 Điếc
deafen 	(v)	 Làm cho điếc tai
deafener 	(n)	 Máy tiêu âm
deafness 	(n)	 Sự điếc
death 	(n)	 Cái chết
deathly 	(a)	 Như chết
decide 	(v)	 Quyết định
decision 	(n)	 Sự quyết định
decisive 	(a)	 Có tính quyết định
decisively 	(adv)	 Thật kiên quyết
decorate 	(v)	 Trang trí , trang hoàng
decoration 	(n)	 Sự trang trí, trang hoàng
decorative 	(a)	 Có tính cách trang trí
decorator 	(n)	 Người trang trí nội thất
deep 	(a)	 Sâu
deeply 	(adv)	 Thật sâu
deepth 	(n)	 Độ sâu, chiều sâu
defeat 	(v	 Đánh bại, sự đánh bại
defeated 	(a)	 Bị đánh bại
defeatist 	(n)	 Người có tinh thần chủ bại
definite 	(a)	 Xác định rõ ràng
definitely 	(adv)	 Thật dứt khoát, rõ ràng
definition 	(n)	 Sự xác định, định nghĩa
deforest 	(v)	 Chặt đốn, phá rừng
deforestation 	(n)	 Nạn phá rừng
delicious 	(a)	 Ngon
deliciously 	(adv)	 Thật ngon
deliciousness 	(n)	 Sự ngon
delight 	(n	 Vui thích ,làm vui thích
delighted 	(a)	 Vui mừng, hài lòng
delightedly 	(adv)	 Vui thích
delightful 	(a)	 Thú vị, ham mê
delightfully 	(adv)	 Thật thú vị
deliver 	(v)	 Giao hàng , chuyên chở tới
deliverer 	(n)	 Người giao hàng
delivery 	(n)	 Sự chở, giao hàng
delverable 	(a)	 Có thể giao hàng
demonstrator 	(n)	 Người biểu dương
demostrate 	(v)	 Biểu tình , biểu dương
demostration 	(n)	 Cuộc biểu tình , biểu dương
deniable 	(a)	 Có thể từ chối
denial 	(n)	 Sự từ chối , khước từ
denier 	(n)	 Người khước từ
deny 	(v)	 Từ chối, phủ nhận
depart 	(v)	 Khởi hành
departer 	(n)	 Người khởi hành
departure 	(n)	 Sự khởi hành
depend 	(v)	 Phụ thuộc
dependence 	(n)	 Sự phụ thuộc
dependency  		 Phần phụ thuộc
dependent 	(a)	 Phụ thuộc , lệ thuộc
depentdently 	(adv)	 Phụ thuộc
deposit 	(v	 Đặt cọc , tiền thế thân
depositor 	(n)	 Người gửi tiền
depository 	(n)	 Kho bạc
describer 	(n)	 Người mô tả
describle 	(v)	 Diễn tả
description 	(n)	 Sự mô tả
descriptive 	(a)	 Miêu tả
descriptively 	(adv)	 Sinh động, sống động
design 	(v)	 Thiết kế
designer 	(n)	 Nhà thiết kế
destination 	(n)	 Điểm đến
destine 	(v)	 Đến nơi
destroy 	(v)	 Phá hoại, hủy diệt
destroyer 	(n)	 Kẻ phá hoại
destruction 	(n)	 Sự hủy diệt
destructive 	(a)	 Phá hoại
destructively 	(adv)	 Tàn phá
develop 	(v)	 Phát triển
developed 	(a)	 Đã phát triển
developing 	(a)	 Đang phát triển
development 	(n)	 Sự phát triển
dfficultly 	(adv)	 Thật khó khăn
die 	(v)	 Chết
difference 	(n)	 Sự khác biệt
different 	(a)	 Khác biệt
differently 	(adv)	 Thật khác biệt
difficult 	(a)	 Khó khăn
difficulty 	(a)	 Sự khó khăn
dip 	(v)	 Nhúng , ngâm
dipper 	(n)	 Người nhúng, ngâm
direct 	(a)	 Trực tiếp
direct 	(v)	 Hướng dẫn , chỉ đường
direction 	(n)	 Phương hướng
directly 	(adv)	 Trực tiếp
director 	(n)	 Người hướng dẫn ,đạo diễn
directory 	(n)	 Niên giám điện thoại
dirt 	(n)	 Vết bẩn
dirtily 	(adv)	 Thật dơ bẩn
dirtiness 	(n)	 Tính dơ bẩn
dirty 	(a)	 Dơ, bẩn
disadvantage 	(n)	 Sự bất lợi
disadvantage 	(v)	 Làm cho bất lợi
disadvantageous 	(a)	 Bất lợi, thiệt thòi
disagree 	(v)	 Bất đồng ,không đồng ý
disagreeable 	(a)	 Khó chịu, khó tính
disagreement 	(n)	 Sự không đồng ý
disappear 	(v)	 Biến mất
disappearance 	(n)	 Sự biến mất
disappointed 	(a)	 Thất vọng, chán nản
disappointedly 	(adv)	 Một cách thất vọng
disappointing 	(a)	 Gây chán nản , bực mình
disappointingly 	(adv)	 Gây chán nản thất vọng
disappointment 	(n)	 Sự chán nản, thất vọng
disaster 	(n)	 Thảm họa, tai nạn
disastrous 	(a)	 Tại họa, thảm khốc
discount 	(v	 Giảm giá, chiết khấu
discountable 	(a)	 Có thể giảm được
discover 	(v)	 Khám phá , phát hiện
discoverable 	(a)	 Có thể khám phá
discoverer 	(n)	 Người khám phá
discovery 	(n)	 Sự khám phá
discuss 	(v)	 Thảo luận ,bàn cãi
discussible 	(n)	 Có thể tranh cãi
discussion 	(n)	 Cuộc thảo luận
dissolution 	(n)	 Sự giải tán
dissolvable 	(a)	 Có thể giải tán
dissolve 	(v)	 Giải tán
dissolvent 	(n)	 Nước đun sôi
distance 	(n)	 Khoảng xa
distant 	(a)	 Khoảng cách, xa xôi
distantly 	(adv)	 Xa xôi, cách trở
distinguish 	(v)	 Nhận biết, phân biệt
distinguishable 	(a)	 Có thể phân biệt
distinguished 	(a)	 Đặc biệt , dáng chú ý, tao nhã
distribute 	(v)	 Phân phối
distribution 	(n)	 Sự phân phối
distributor 	(n)	 Nhà phân phối
divide 	(v)	 Phân chia
divider 	(n)	 Người phân chia, phân phối
divisable 	(a)	 Có thể chia được
division 	(n)	 Sự phân chia
dizzily 	(adv)	 Hoa mắt, chóng mặt
dizziness 	(n)	 Sự hoa mắt
dizzy 	(a)	 Hoa mắt
dizzy 	(v)	 Làm hoa mát
document 	(n)	 Hồ sơ, tài liệu
document 	(v)	 Cung cấp tài liệu
documental 	(n)	 Thuộc về tài liệu
documentary 	(a)	 Đề làm tài liệu
documentary 	(a)	 Phim tài liệu
drama 	(n)	 Kịch
dramatic 	(a)	 Thuộc về kịch
dramatics 	(v)	 Kịch trường
dramatist 	(n)	 Nhà soạn kịch
dramatize 	(v)	 Soạn kịch , diễn kịch
draw 	(v)	 Vẽ
drawing 	(n)	 Bảng vẽ, bức vẽ
dress 	(v	 Mặc đồ, quần áo
dressing 	(n)	 Sự ăn mặc
dressmaker 	(n)	 Thợ may
dressy  		 Lịch sự, hợp thời trang 
drier 	(n)	 Máy làm khô
drip 	(v	 Chảy nhỏ giọt
dripping 	(n)	 Sự chảy nhỏ giọt
drive 	(v)	 Lái xe
driver 	(n)	 Tài xế
drought 	(n)	 Sự khô hạn
droughty  		 Hạn hán , khô ráo
drum 	(v)	 Đánh trống
drummer 	(n)	 Người đánh trống , tay trống
drumming 	(n)	 Tiếng trống
dry 	(a	 Khô ráo, làm cho khô
drying 	(n)	 Sự phơi khô
dryly 	(adv)	 Một cách khô ráo
durm 	(n)	 Cái trống
dutiful 	(a)	 Có trách nhiệm
dutifully 	(adv)	 Đầy trách nhiệm
duty 	(n)	 Nhiệm vụ
dying ≠ deathless 	≠	 Hấp hối ≠ Bất tử
dynamite 	(n)	 Mìn, thuốc nổ
dynamite 	(v)	 Làm nổ thuốc nổ
dynamiter 	(n)	 Người làm nổ mình
eager 	(a)	 Hăng hái
eagerly 	(adv)	 Thật hăng hái
eagerness 	(n)	 Sự hăng hái
earn 	(v)	 Kiếm tiền
earnest 	(n)	 Tiền cọc
earnings 	(n)	 Tiền công ,tiền lương
ease 	(v	 Làm cho dễ dàng
easily 	(adv)	 Thật dễ dàng
easiness 	(n)	 Sự dễ dàng
east 	(n)	 Hướng đông
easter 	(n)	 Lễ Phục sinh
eastern 	(a)	 Thuộc về hướng đông
eastward 	(adv)	 Về phía đông
easy 	(a)	 Dễ dàng
economic 	(a)	 Kinh tế, tiết kiệm
economical 	(a)	 Kinh tế, tiết kiệm
economically 	(adv)	 Thật kinh tế
economies 	(n)	 Khoa kinh tế học
economize 	(n)	 Tiết kiệm
economy 	(n)	 Nền kinh tế
edit 	(v)	 Làm chủ bút , xuất bản
editing 	(n)	 Biên tập báo
edition 	(n)	 Sự xuất bản, lần phát thanh
editor 	(n)	 Nam chủ bút, nhà xuất bản
editorship 	(n)	 Chức vụ chủ bút
editress 	(n)	 Nữ chủ bút
educate 	(v)	 Giáo dục
education 	(n)	 Sự giáo dục
educational 	(n)	 Thuộc về ngành giáo dục
educative 	(a)	 Có tác dụng giáo dục
educative 	(n)	 Có tác dụng giáo dục
educator 	(n)	 Người giáo dục, thầy dạy
effect 	(v)	 Gây hiệu quả , thực hiện
effective 	(a)	 Có hiệu lực, hiệu quả
effectively 	(adv)	 có hiệu quả
effectiveness 	(n)	 Sự gây ấn tượng sâu sắc
efficiency 	(n)	 Hiệu lực, hiệu quả, năng suất
efficient 	(a)	 Có hiệu quả, năng suất cao
efficiently 	(adv)	 Một cách hiệu quả
eld 	(n)	 Tuổi già
elder 	(a)	 Lớn tuổi, già dặn hơn
elder 	(n)	 Cha ông , người lớn, tiên sinh
elderly 	(a)	 Đứng tuổi, cao niên
eldest 	(a)	 Lớn tuổi nhất
elect 	(v)	 Bầu, chọn , chọn lọc
election 	(n)	 Kẻ bầu cử, tuyển chọn
elective 	(a)	 Có quyền bầu cử
electively 	(adv)	 Có quyền bầu cử
elector 	(n)	 Cử tri (nam)
electoress 	(n)	 Cử tri (nữ )
electric 	(a)	 Có điện
electrical 	(a)	 Thuộc về điện
electricician 	(n)	 Thợ điện
electricity 	(n)	 Điện cực
electrify 	(v)	 Điện khí hóa
electronic 	(a)	 Thuộc về điện tử
electronics 	(n)	 Môn học điện tử
eletrification 	(n)	 Sự điện khí hóa
elevate 	(v)	 Nâng cao, đề cao
elevated 	(a)	 Cao
elevation 	(n)	 Sự nâng cao
elevator 	(n)	 Thang máy, máy nâng
embroider 	(v)	 Thêu thùa
embroidered 	(n)	 Được thêu
embroiderer 	(n)	 Thợ thêu (nam )
embroideress 	(n)	 Thợ thêu (nữ)
embroidery 	(n)	 Nghề thêu , đồ thêu , mẫu thuê
emigrant 	(n)	 Dân di cư
emigrantory 	(a)	 Di cư
emigrate 	(v)	 Xuất ngoại , di cư
emigration 	(n)	 Sự di cư, xuất ngoại
employ 	(v	 Thuê, việc làm
employable 	(a)	 Có thể thuê được
employee 	(n)	 Người làm công ,công nhân
employer 	(n)	 Người chủ, người thuê
emplyment 	(n)	 Sự làm công, việc làm
emptily 	(adv)	 Thật trống rỗng
emptiness 	(n)	 Tình trạng trống rỗng
empty 	(a)	 Trống , rỗng
empty 	(v)	 Đổ, dốc, làm cạn
enable 	(v)	 Làm cho có thể
encourage 	(v)	 Khích lệ, làm cho can đảm
encourage 	(v)	 Khuyến khích, cổ vũ
encouragement 	(n)	 Sự khuyến khích
encouragement 	(n)	 Sự khuyến khích, động viên
encouraging 	(a)	 Khích lệ, phấn khởi
encouragingly 	(adv)	 Thật phấn khởi
end 	(n)	 Phần cuối, kết thúc
end 	(v)	 Làm xong, hoàn thành
ended 	(a)	 Xong, hoàn thành
ending 	(n)	 Sự làm xong
endless 	(a)	 Vô cùng , vô tận
energetic 	(a)	 Quyết liệt, hiếu động
energetically 	(adv)	 Hăng hái, manh động
energise 	(v)	 Làm cho mạnh mẽ
energizer 	(n)	 Người làm cho mạnh mẽ
energy 	(n)	 Năng lượng , nghị lực
england 	(n)	 Nước Anh
english 	(a)	 Thuộc về nước Anh
english 	(n)	 Người anh , Tiếng Anh
enhance 	(v)	 Làm tăng thêm, nâng cao
enhancement 	(n)	 Sự làm nổi bật hơn
enjoy 	(v)	 Thích thú , thưởng thức
enjoyable 	(a)	 Thú vị thích thú
enjoyably 	(adv)	 Thú vị
enjoyment 	(n)	 Sự thú vị
enormous 	(a)	 To lớn, khổng lồ
enormously 	(adv)	 Thật to lớn
enrich 	(v)	 Làm giàu
enter 	(v)	 Nhập vào, đi vào
enterable 	(a)	 Có thể vào được
entering 	(n)	 Sự đi vào
entertain 	(v)	 Tiêu khiển, tiếp đãi
entertainer 	(n)	 Người đãi tiệc, giúp vui
entertaining 	(a)	 Vui, giải trí
entertainingly 	(adv)	 Hấp dẫn
entertainment 	(n)	 Sự giải trí
entrance 	(n)	 Cửa vào, lối vào
enviroment 	(n)	 Môi trường
enviromentalist 	(n)	 Nhà nghiên cứu môi trường
environmental 	(a)	 Thuộc về môi trường
equal 	(n)	 (v) Bằng nhau
equality 	(n)	 Sự bằng nhau
equalization 	(n	 Sự chia đều 
equalize 	(v)	 San bằng
equalizer 	(n)	 Bộ phận (người cân bằng )
equally 	(adv)	 Bằng nhau , ngang bằng nhau
equip 	(v)	 Trang bị
equipment 	(n)	 Thiết bị
equipped 	(a)	 Được trang bị
erase 	(v)	 Xóa ,tẩy
erasement 	(n)	 Sự tẩy xóa
eraser 	(n)	 Người xóa, cục tẩy
erasibility 	(n)	 Tẩy được
erupt 	(v)	 Phun ra, nhô ra
eruption 	(n)	 Sự phun ra (núi lửa )
eruptional 	(a)	 Phun trào ra
especial 	(a)	 Riêng biệt, đặc biệt
especially 	(adv)	 Đặcb iệt, nhất là
establish 	(v)	 Thành lập, thiết lập
established 	(a)	 Đã được thiết lập
establisher 	(n)	 Người thiết lập
establishment 	(n)	 Sự thiết lập
ethnical 	(a)	 Dân tộc
ethnographer 	(n)	 Nhà nhân chứng học
ethnographic 	(a)	 Thuộc về dân tộc học
ethnography 	(n)	 Dân tộc, nhân chứng học
ethnological 	(a)	 Thuộc về dân tộc học
ethnologist 	(n)	 Nhà dân tộc học
ethnology 	(n)	 Dân tộc học
evidence 	(n)	 Chứng cớ, minh bạch
evident 	(a)	 Minh bạch ,rõ ràng
evidential 	(a)	 Có chứng cớ
evidently 	(adv)	 Rõ ràng, minh bạch
exact 	(a)	 Chính xác
exact 	(v)	 Đòi hỏi, yêu sách
exactly  		 Thật chính xác
exam  		 Kỳ thi
examina 	(v)	 Thi, kiểm tra, xét hỏi
examinational 	(a)	 Thuộc về thi cử
examinee 	(n)	 Thí sinh ,người dự thi
examiner 	(n)	 Giám khảo
excel 	(n)	 Giỏi hơn, xuất chúng
excellent 	(a)	 Xuất sắc
excellently 	(adv)	 Thật xuất sắc
except 	(v)	 Trừ ra, phản đối
exception 	(n)	 Sự loại trừ
exceptionable 	(a)	 Có thể bị phản đối
exceptionality 	(n)	 Tính ngoại lệ
exceptive 	(a)	 Để trừ ra
exchange 	(v	 Trao đổi, sự trao đổi
exchangeable 	(a)	 Có thể trao đổi
excite 	(v)	 Hào hứng
excited 	(a)	 Bị kích thích
excitedly 	(adv)	 Thật hào hứng , xúc động
excitement 	(n)	 Sự hào hứng, phấn khởi
exciting 	(a)	 Hào hứng
excitingly 	(adv)	 Thật hào hứng
exellency 	(n)	 Sự xuất sắc
exhaust 	(v	 Thoát ra, hút, làm cạn
exhausted 	(a)	 Mệt sức, mệt lả
exhauster 	(n)	 Máy hút
exhaustible 	(a)	 Có thể làm cạn kiệt, hao mòn
exhausting 	(a)	 Làm kiệt sức
exhaustion 	(n)	 Sự làm cạn kiệt, hút hết
exhibit 	(v)	 Trưng bày, phô trương
exhibition 	(n)	 Cuộc triễn lãm, trưng bày
exhibitionist 	(n)	 Người có tính phô trương
exhibitor 	(n)	 Người bày hàng, triễn lãm
exhibitory 	(a)	 Phô bày, triễn lãm
exist 	(v)	 Tồn tại
existence 	(n)	 Sự tồn tại
existent 	(a)	 Hiện còn, đang tồn tại
existing 	(a)	 Hiện hữu, hiện có
expect 	(v)	 Chờ đợi, mong ngóng
expectance 	(n)	 Sự mong đợi
expectant 	(a)	 Chờ đợi, mong ngóng
expectantly 	(adv)	 Một cách mong đợi
expectation 	(n)	 Sự chờ đợi
expectative 	(a)	 Có thể mong đợi
expecter 	(n)	 Người chờ đợi
expend 	(v)	 Tiêu xài
expendable 	(a)	 Có thể tiêu xài
expense  		 Tiền chi tiêu
expensively 	(adv)	 Thật đắt tiền
expensiveness 	(n)	 Sự mắc mỏ
experience 	(v	 Kinh nghiệm, từng trải
experienced 	(a)	 Có kinh nghiệm
experiential 	(n)	 Dựa vào kinh nghiệm
experiment 	(v)	 Thí nghiệm, cuộc thí nghiệm
experimental 	(a)	 Có tính chất thí nghiệm
experimenting 	(n)	 Sự thí nghiệm
experimeter 	(n)	 Người thí nghiệm
explain 	(v)	 Giải thích
explaination 	(n)	 Sự giải thích
explanatory 	(a)	 Có thể giải thích
explode 	(v)	 Nổ , làm nổ
exploration 	(n)	 Cuộc thám hiểm
exploratory 	(a)	 Khám phá, tìm tòi
explore 	(v)	 Thám hiểm, thăm dò
explorer 	(n)	 Nhà thám hiểm
exploring 	(n)	 Sự thám hiểm
explosion 	(n)	 Vụ nổ, tiếng nổ
explosive 	(a)	 Dễ nổ
explosive 	(n)	 Chất nổ
explosively 	(adv)	 Mạnh mẽ, dữ dội
exponsive 	(n)	 Đắt tiền, mắc
exposition 	(n)	 Sự bình luận , minh giải
expositive 	(a)	 Giải nghĩa
expositor 	(n)	 Người giải thích , chú thích
express 	(v)	 Phát biểu, bày tỏ
expression 	(n)	 Sự biểu lộ
expressive 	(a)	 Diễn cảm, diễn đạt
expressively 	(adv)	 Thật biểu cảm
extreme 	(a)	 Hết sức, cực độ
extremeness 	(n)	 Tính cực đoan
extremist 	(n)	 Người theo chủ nghĩa cực đoan
extremly 	(adv)	 Vô cùng tột bậc
fabric 	(n)	 Sự dệt vải , cấu tạo
fabricate 	(v)	 Xếp đặt ,cấu tạo
fabrication 	(n)	 Sự chế tạo, tổ chức
fabricator 	(n)	 Người chế tạo
fade 	(v)	 Khô héo, tàn úa , phai màu
faded ≠ fadeless 	≠	 Khô héo, tàn úa , phai màu
fail 	(v	 Rớt, thất bại , không thành
failure 	(n)	 Sự thất bại, thi hỏng
faint 	(a	 Mệt mỏi, kiệt sức
fainting 	(a)	 Tình trạng mệt mỏi
faintness 	(n)	 Sự yếu , đói
fair 	(a)	 Xinh xắn, hợp lí, vàng hoe
fairly 	(adv)	 Công bằng, lịch sự
fairness 	(n)	 Sự công bằng
faith 	(n)	 Sự thành thục
faithful 	(a)	 Trung thành, chung thủy
faithfully 	(adv)	 Thật thành thực, trung thành
faithfulness ≠ faithless 	≠	 Lòng trung thành
fame 	(n)	 Nổi tiếng
famous 	(a)	 Không thành thật
famously 	(adv)	 Danh vọng, sự nổi tiếng
far 	(a)	 Thật nổi tiếng
farm 	(n)	 Xa nhất
farmer 	(n)	 Nông trang
farming 	(n)	 Công việc đồng án
farther 	(a)	 Xa
farthest 	(a)	 Xa hơn
fascinate 	(v)	 Quyến rũ
fascinating 	(a)	 Hấp dẫn, lôi cuốn
fascination 	(n)	 Sự quyến rũ
fascinator 	(n)	 Người lôi cuốn, quyến rũ
fashion 	(n)	 Mốt, thời trang
fashion 	(v)	 Tạo thành mốt, chế tạo
fashionable 	(a)	 Hợp thời trang
fashionably 	(adv)	 Thật đúng mốt
fast 	(a	 Nhanh
fastness 	(n)	 Sự nhanh lẹ
fat 	(a	 Mập, béo, mỡ
fatness ≠ fatless 	≠	 Sự mập mạp ≠ ít mỡ, gầy
fatten 	(v)	 Nuôi cho mập
fatty 	(a)	 Có nhiều mỡ
favor 	(v)	 Ưa thích nhất
favorite 	(a)	 Ưa thích nhất
favour 	(n)	 Sự ưa thích
feel 	(v)	 Cảm thấy
feeling 	(a)	 Có cảm tình
feeling 	(a)	 Tình cảm
feelingly 	(adv)	 Có cảm tình
ferment 	(v)	 Lên men , ủ men
fermentable 	(a)	 Có thể lên men
fermentation 	(n)	 Sự lên men
fermentative 	(a)	 Làm lên men
fertilization 	(n)	 Sự làm cho màu mỡ
fertilize 	(v)	 Làm cho màu mỡ
fertilizer 	(n)	 Phân bón
fertilze 	(a)	 Tốt, phì nhiêu
festival 	(n)	 Ngày lễ hội
festive 	(a)	 Thuộc về lễ hội
festivity 	(n)	 Sự vui mừng lễ hội
final 	(a)	 Cuối cùng
finalization 	(n)	 Sự hoàn thành
finalize 	(v)	 Hoàn thành, làm xong
finally 	(adv)	 Cuối cùng
firm 	(v	 Vững chắc , kiên cố
firmly 	(adv)	 Thật vững chắc
firmness 	(n)	 Sự vững chắc
first 	(a)	 Trước hết, thứ nhất
firstly 	(adv)	 Trước hết, trước tiên
fish 	(n	 Cá , con cá, câu cá, đánh cá
fisherman 	(n)	 Ngư dân, người đánh cá
fishery 	(n)	 Nghề đánh cá
fishing 	(n)	 Sự câu cá, đánh cá
fit 	(a)	 Vừa, thích hợp
fit 	(n	 Sự làm cho vừa
fitness 	(n)	 Sự vừa vặn
flat 	(a)	 Bằng phẳng
flat 	(n)	 Căn hộ
flaterer 	(n)	 Lời nịnh hót, sự xu nịnh
flatly 	(adv)	 Thẳng
flatness 	(n)	 Sự bằng phẳng
flatter 	(v)	 Người nịnh bợ
flatteringly 	(adv)	 Nước lụt
flattery 	(n)	 Nịnh hót, xu nịnh
flatton 	(v)	 Nịnh hót, làm vui
flood 	(n)	 Làm ngập lụt
flood 	(v)	 Dễ dẫn nước, dễ ngập
floodable 	(a)	 Lưu loát
fluency 	(n)	 Sương mù
fluent 	(a)	 Thật lưu loát
fluently 	(adv)	 Sự lưu loát
fog 	(n)	 Có sương mù
foggy 	(a)	 Xếp, gấp bao gọc, gói lại
fold 	(n)	 Người xếp, bìa hồ sơ
fold 	(v)	 Nếp gấp nếp nhăn
folder 	(n)	 Có thể xếp được
folding 	(a)	 Làm bộ ngu si, khờ dại
fool 	(n)	 Sự ngu si, khờ dại
fool 	(v)	 Người ngu si
foolery 	(n)	 Ngu si, đần độn
foolish 	(a)	 Ngu si, đần độn
foolishness 	(n)	 Sự đần độn
force 	(n)	 Sức mạnh , lực lượng
force 	(v)	 Cưỡng ép, ép buộc
forced 	(a)	 Bị ép, miễn cưỡng
forcedly 	(adv)	 Bắt buộc, gượng ép
forceful  		 Mạnh mẽ, cường tráng 
forecast 	(v	 Ước đoán, dự báo trước
foreign 	(a)	 nước ngoài, lạ, không quen
foreigner 	(n)	 Người nước ngoài
foreignize 	(v)	 Làm xa lạ
foreman 	(n)	 Thợ cả, bồi thẩm đoàn
foremanship 	(n)	 Chức đốc công , chủ tịch
forest 	(n	 Khu rừng, trồng rừng
forestation 	(n)	 Sự trồng rừng 
forget 	(v)	 Quên
forgetful 	(a)	 Cố tình hay quên, dễ quên
forgetfulness 	(n)	 Tính hay quên
formal 	(a)	 Nghi tức trang trọng, hiểu cách
formality 	(n)	 Nghi thức, thủ tục
formalize 	(n)	 Nghi thức hóa
formally 	(adv)	 Một cách chính thức
fortunate 	(a)	 May mắn
fortunately 	(adv)	 Thật may mắn
fortune 	(n)	 Vạn may
found 	(v)	 Thành lập , sáng lập
foundation 	(n)	 Sự sáng lập
founder 	(n)	 Người sáng lập (nam)
foundress 	(n)	 Ngườ sáng lập (nữ )
fprecaster 	(n)	 Người dự báo thời tiết
free 	(a)	 Rảnh, tự do
free 	(v)	 Làm cho rảnh
freedom 	(n)	 Sự rảnh, tự do
freely 	(adv)	 Tự do ,thật rảnh
freeze 	(v)	 Đóng băng, ngăn cản
freezer 	(n)	 Máy ướp lạnh
freezing 	(n)	 Sự đông lại
frequency  		 Sự thường xuyên
frequent 	(a)	 Thường xuyên
frequently 	(adv)	 Thường xuyên
fresh 	(a)	 Tươi mát, sạch
freshen 	(v)	 Làm cho tươi mát
freshly 	(adv)	 Thật tươi mới
freshness 	(n)	 Sự mát mẻ
friend 	(n)	 Bạn bè
friendliness 	(n)	 Sự thân thiện
friendly 	(a)	 Thân thiết
friendship 	(n)	 Tình bạn
frighten 	(v)	 Dọa , làm cho sợ
frightened 	(a)	 Sợ hãi, hoảng sợ
frightening 	(a)	 Ghê sợ, khủng khiếp
frighteningly 	(adv)	 Một cách ghê sợ
frightful 	(a)	 Đáng sợ
full 	(a)	 No, đầy
fullness 	(n)	 Sự đầy đủ
fully 	(adv)	 Đầy đủ
fume 	(n)	 Hơi khói, bốc lên
fume 	(v)	 Xông hương ,bốc khói
fumigate 	(v)	 Xông khói, xông hơi
fumigation 	(n)	 Sự xông hơi
fumigator 	(n)	 Người xông khói, hơi
fuming 	(a)	 Lên khói, nóng giận
fumy 	(a)	 Có khói , nhiều khói
fun 	(n)	 Niềm vui
funnel 	(n)	 Cái phễu, ống khói
funnelled 	(a)	 Có hình cái phễu
funnily 	(adv)	 Thật vui
funny 	(a)	 Vui
furnish 	(v)	 Trang bị đồ đạc trong nhà
furnisher 	(n)	 Người cung cấp, bán đồ đạc
furnishings 	(n)	 Đồ dùng trong nhà
furniture 	(n)	 Bàn ghế đồ đạc trong nhà
garden 	(v	 Làm vườn, khu vườn
gardener 	(n)	 Ngườ làm vườn
gardening 	(n)	 Nghề làm vườn
generate 	(v)	 Sinh ra, gây ra
generating 	(a)	 Phát sinh
generation 	(n)	 Thế hệ sự phát ra
generative 	(a)	 Có thể sinh ra
generator 	(n)	 Máy phát điện
generous 	(a)	 Rộng rãi, hào phóng
generousity 	(n)	 Lòng khoan dung
generously 	(adv)	 Thật hào phóng
gentle 	(a)	 Nhẹ nhàng, dịu dàng
gently 	(adv)	 Thật nhẹ nhàng
geographer 	(n)	 Nhà địa lý
geographical 	(a)	 Thuộc về đại lý
geographically 	(adv)	 Về phương din đại lý
geography 	(n)	 Địa lý học
german 	(a)	 Thuộc về nước Đức, người Đức
germany 	(n)	 Nước Đức
glad 	(a)	 Vui vẻ, vui mừng
gladden 	(v)	 Làm vui vẻ
gladly 	(adv)	 Thật vui vẻ
glass 	(n)	 Thủy tinh, kiếng , ly
glass 	(v)	 Lắp kiếng
glassy 	(a)	 Như thủy tinh
glorious 	(a)	 Huy hoàng
gloriously 	(adv)	 Thật vinh quang
glory 	(n	 Vinh quang
godness 	(n)	 Lòng tốt
gold 	(n)	 Vàng
golden 	(a)	 Bằng vàng
good 	(a)	 Tốt
good 	(a)	 Tốt, khỏe
goodness 	(n)	 Lòng tốt
govern 	(v)	 Cai trị, quản lý
governable 	(a)	 Có thể cai trị
governance 	(n)	 Sự cai trị, quản lý
government 	(n)	 Chính phủ , chính quyền
governmental 	(a)	 Thuộc về chính phủ
governor 	(n)	 Người cai trị, tỉnh trưởng
grade 	(n)	 Lớp hạng, điểm số
grade 	(v)	 Xếp hạng, xếp lớp ,cấp độ
grader 	(n)	 Người lựa chọn
grammar 	(n)	 Ngữ pháp
grammarian 	(n)	 Người soạn ngữ pháp
grammartical 	(a)	 Thuộc về văn phạm
grammarticize 	(v)	 Làm cho đúng văn phạm
grass 	(n)	 Cỏ
grass 	(v)	 Trồng cỏ
grassy 	(a)	 Có cỏ
greateful 	(a)	 Biết ơn, mang ơn
greatfully 	(adv)	 Một cách biết ơn
greatfulness 	(n)	 Lòng biết ơn
greed 	(n)	 Sự tham ăn
greediness 	(n)	 Tính háu ăn
greet 	(v)	 Chào hỏi
greeter 	(n)	 Người chào hỏi
greeting 	(n)	 Lời chào hỏi
grent 	(a)	 To lớn, vĩ đại
grenten 	(v)	 Làm lớn ra
grently 	(adv)	 Thật vĩ đại
grentness 	(n)	 Sự to lớn, vĩ đại
grocer 	(n)	 Người bán tạp hóa
groceries 	(n)	 Hàng tạp hóa
grocery 	(n)	 Cửa hàng tạp hóa
groodily 	(adv)	 Một cách tham lam
groody 	(a)	 Tham lam , thèm muốn
grow 	(v)	 Mọc, trồng
growable 	(a)	 Có thể trồng được
grower 	(n)	 Người trồng cây
growth  		 Sự trưởng thành
guarantee 	(n)	 Sự đảm bảo
guarantee 	(v)	 Bảo đảm, bảo hành
guaranteed 	(a)	 Có bảo chứng
guarantor 	(n)	 Nhà bảo hành
guaranty 	(n)	 Giấy bảo đảm
guide 	(v)	 Hướng dẫn
guideless 	(a)	 Không có người hướng dẫn
guideline 	(n)	 Đường lối chỉ đạo
guider 	(n)	 Người hướng dẫn
habbit 	(n)	 Thói quen
habbitual 	(a)	 Thói quen
habbituate 	(v)	 Tập cho quen
habitually 	(adv)	 Thường xuyên
handicap 	(n)	 Khuyết điểm, chấp nhau
handicapped 	(a)	 Bất lợi, khuyết điểm
handicapper 	(n)	 Người chấp nhau
happily 	(adv)	 Thật vui vẻ
happiness ≠ unhappy 	≠	 Sự vui vẻ ≠ không vui vẻ
happy 	(a)	 Vui vẻ , hạnh phúc
hard 	(a	 Chăm chỉ, cực nhọc, cứng
harden 	(v)	 Làm cho cứng
hardly 	(adv)	 Khó khăn
hardness 	(n)	 Sự cứng rắn
harvest 	(v	 Thu hoạch ,gạch hái
harvester 	(n)	 Người gặt, máy gặt
head 	(n)	 Cái đầu
headache 	(n)	 Cơn đau đầu
headed 	(a)	 Có ghi ở đầu
header 	(n)	 Cú đội đầu , vòi phun
headless 	(a)	 Không có đầu
headline 	(v)	 Đặt ở dòng đầu
headman 	(n)	 Người đứng đầu
heaing 	(n)	 Đề mục, tiêu đề
health 	(n)	 Sức khỏe
healthful 	(a)	 Có lợi cho sức khỏe
healthily 	(adv)	 Thật khỏe mạnh
healthy 	(a)	 Khỏe mạnh
heart 	(n)	 Trái tim, trung tâm
heartily 	(adv)	 Thật nồng nhiệt
heartiness 	(n)	 Sự nồng nhiệt
heartlessly 	(adv)	 Thật vô tâm
hearty 	(a)	 Vui vẻ, thân mật
heat 	(n	 Sức nóng, đốt nóng
heated 	(a)	 Nóng giận dữ
heatedly 	(adv)	 Một cách nóng nảy
heater 	(n)	 Lò sưởi , người đốt
heavily 	(adv)	 Thật nặng
heavily 	(adv)	 Thật nặng nề
heaviness 	(n)	 Sự nặng nề
heavy 	(a)	 Nặng
heavy 	(a)	 Nặng
height 	(n)	 Chiều cao
heighten 	(v)	 Làm cho cao
help 	(v)	 Giúp đỡ
helper 	(n)	 Người giúp việc
helpful 	(a)	 Có ích, hữu dụng
helpfully 	(adv)	 Thật hữu dụng
helpless 	(a)	 Vô dụng
helplessly 	(adv)	 Thật vô dụng
heritability 	(n)	 Sự có thể thừa kế
heritable 	(a)	 Có thể thừa kế
heritage 	(n)	 Di sản, tài sản, gia tài
high 	(a)	 Cao (dùng cho vật)
highly 	(adv)	 Thật cao
hill 	(n)	 Ngọn đồi, dốc
hilly 	(a)	 Có nhiều đồi, gồ ghề
hindu 	(n)	 Người theo đạo Ấn
hinduism 	(n)	 Ấn Độ giáo
hirable 	(a)	 Có thể thuê mướn được
hire 	(n	 Thuê, mướn, cho thuê
hired 	(a)	 Thuê, để cho thuê
hirer 	(n)	 Người mướn, thuê
hiring 	(n)	 Sự thuê mướn
historic 	(a)	 Có tính chất lịch sử
historical 	(a)	 Thuộc về lịch sử
historically 	(adv)	 Về mặt lịch sử
historism 	(n)	 Nhà sử học
history 	(n)	 Lịch sử
home 	(a	 Địa phương ,ở tại nhà
home 	(n)	 Nhà, chỗ ở
homeland 	(n)	 Quê hương ,tổ quốc
homesick 	(a)	 Nhớ nhà
homework  		 Bài tập về nhà
honest 	(a)	 Trung thự, chân thành
honestly 	(adv)	 Thành thật, trung thực
honesty 	(n)	 Tính chân thật
honor 	(n)	 Danh dự, lòng tôn kính
honorable 	(a)	 Đáng tôn vinh
honorably 	(adv)	 Đáng vinh dự
honored 	(a)	 Được tôn vinh
honour  		 Tôn trọng, tôn vinh
hope 	(v)	 (n) Hi vọng
hopeful 	(a)	 Có hi vọng
hopefully  		 Có hi vọng 
hopelessly 	(adv)	 Thật thất vọng
hopistalise 	(v)	 Cho nhập viện
hopistality 	(n)	 Lòng mến khách
horrible 	(a)	 Khủng khiếp, kinh khủng
horribleness 	(n)	 Sự kinh khủng
horribly 	(adv)	 Thật kinh khủng
hospital 	(n)	 Bệnh viện
hot 	(a)	 Nóng
hotly 	(a)	 Nóng giận, sôi nổi
hour 	(n)	 Giờ
hourily 	(adv)	 Hàng giờ
huge  		 Khổng lồ
hugely 	(adv)	 Thật to lớn
hugeness 	(n)	 Sự to lớn
human 	(a	 Thuộc về người, loài người
humane 	(a)	 Có lòng nhân đạo
humaneness 	(n)	 Lòng nhân đạo
humanism 	(n)	 Khoa học nhân văn
humanist 	(n)	 Nhà nghiên cứu nhân văn
humanity 	(n)	 Nhân loại, nhân đạo
humanize 	(v)	 Làm cho hợp tính người
humankind 	(n)	 Loài người, nhân loại
humanly 	(adv)	 Theo cách thức nhân loại
humid 	(a)	 ẩm ướt, ẩm thấp
humidifier 	(n)	 Máy giữ độ ẩm
humidify 	(v)	 Làm cho ẩm
humidity 	(n)	 Độ ẩm, ẩm thấp
humor 	(n)	 Hài hước, châm biếm
humorist 	(n)	 Người khôi hài, vui tính
humorous 	(a)	 Châm biếm, hài hước, vui
humorousness 	(n)	 Tính khôi hài
hunger 	(n)	 Sự đói khát
hungrily 	(adv)	 Thật đói khát
hungry 	(a)	 Đói
hurricane 	(n)	 Cơn bão tố
hurried 	(n)	 Vội vàg
hurriedly 	(adv)	 Thật vội vàng
hurry 	(n)	 Sự vội vã
hurt 	(v)	 Làm cho đau, bị thương
hurtful 	(a)	 Có hại, xúc phạm
hurtfullness 	(n)	 Sự có hại 
husk 	(n)	 Trấu , vỏ
husk 	(v)	 Xay lúa, giã , gạo
husked 	(a)	 Đã lột vỏ
huskily 	(adv)	 Một cách khàn khàn
huskiness 	(n)	 Sự khan tiếng
husky 	(a)	 Có vỏ, khàn khàn
identical 	(a)	 Đúng, giống
identically 	(adv)	 Tương tự, yy hết
identification 	(n)	 Sự đồng nhất
identify 	(v)	 Nhận ra
iitinterant 	(n)	 Người có công việc lưu động
ill 	(a)	 Đu, yếu
illness 	(n)	 Sự đau yếu
image 	(n)	 ảnh , hình ảnh , hình tượng
image 	(v)	 Vẽ hình, phản ảnh
imagery 	(n)	 Hình ảnh tượng , đồ khắc
imaginary 	(a)	 ảo, tưởng tượng, ảo tưởng
imagination 	(n)	 Trí tưởng tượng
imaginative 	(a)	 Giải tưởng tượng
imagine 	(v)	 Tưởng tượng, hình dung
imaginism 	(n)	 Chủ nhĩa hình tượng
imagistic 	(a)	 Thuộc chủ nghĩa hình tượng
immediacy 	(n)	 Sự cấp bách
immediate 	(a)	 Trực tiếp, lập tức
immediately 	(adv)	 Ngay lập tức, tức thì
impact 	(v	 Va chạm, cọ xát
impaction 	(n)	 Sự va chạm
impactive 	(a)	 Do va chạm
impatience 	(n)	 Sự thiếu kiên nhẫn
impatient 	(a)	 Thiếu kiên nhẫn
impatiently 	(adv)	 Nôn nóng
importance 	(n)	 Tầm quan trọng
important 	(a)	 Quan trọng
importantly 	(adv)	 Thật quan trọng
impress 	(v)	 Tạo ấn tượng, cảm kích
impression 	(n)	 Ấn tượng ,cảm tưởng
impressive 	(a)	 Gây ấn tượng
impressively 	(adv)	 Có ấn tượng
imprison  		 Bị ở tù
improve 	(v)	 Cải tiến
improvement 	(n)	 Sự tiến bộ
improver 	(n)	 Người cải tiến
include 	(v)	 Bao gồm, chứa đựng
included 	(a)	 Đã có ở trong ,kể cả
including 	(a)	 Kể cả, bao gồm
inclusion 	(n)	 Sự bao gồm
inclusive 	(a)	 Bao gồm , kể cả
incomplete 	(a)	 Thiếu, không đầy đủ
incompletely 	(adv)	 Thiếu, không đủ
incompleteness 	(n)	 Sụ thiếu hụt
increase 	(v)	 Tăng lên
increaser 	(n)	 Người làm tăng
increasing 	(a)	 Tăng dần
increasingly 	(adv)	 Tăng dần
indention 	(n)	 Mục đích , ý định
independence 	(n)	 Sự độc lập
independent 	(a)	 Độc lập
independently 	(adv)	  cách độc lập
india 	(n)	 Nước Ấn Độ
indian 	(a	 Thuộc về Ấn Độ, người Ấn
industrial 	(a)	 Thuộc về công nghiệp
industrialize 	(v)	 Công nghiệp hóa
industrially 	(adv)	 Về mặt công nghiệp
industry 	(n)	 Công nghiệp
inedible  		 Không thể ăn được
inerease 	(n)	 Sự gia tăng
inferior 	(a	 Nhỏ hơn ,cấp dưới
inferiority 	(n)	 Sự thấp kém , bậc dưới
influence 	(n)	 ảnh hưởng, tác dụng
influential 	(a)	 Có ảnh hưởng
influentially 	(adv)	 Có tác dụng
inform 	(v)	 Báo tin
informant 	(n)	 Người báo tin
information 	(n)	 Thông tin , tin tức
informative 	(a)	 Có nhiều thông tin
inherit 	(v)	 Thừa hưởng
inheritable 	(a)	 Có thể thừa kế
inheritance 	(n)	 Gia tài, di sản
inheritor 	(n)	 Người thừa kế
inheritor 	(n)	 Người thừa kế (nam )
inheritress 	(n)	 Người thừa kế (nữ)
injure 	(v)	 Làm bị thương
injured 	(a)	 Bị thương, bị xúc phạm
injurious 	(a)	 Có hại
injury 	(n)	 Vết thương ,sự thiệt hại
innovate 	(v)	 Đổi mới ,cách tân
innovating 	(a)	 Đổi mới , cách tân
innovation 	(n)	 Sự đổi mới
innovator 	(n)	 Người đổi mới
inquiere 	(n)	 Người thẩm tra
inquiering 	(a)	 Thắc mắc, học hỏi
inquirable 	(a)	 Có thể điều tra
inquire 	(v)	 Điều tra, thảm hỏi
inquiringly 	(adv)	 Điều tra
inquiry 	(n)	 Cuộc điều ra, thảm hỏi
inspirable 	(a)	 Có thể tạo cảm hứng
inspiration 	(n)	 Nguồn cảm hứng
inspirational 	(a)	 Gây cảm hứng
inspire 	(v)	 Truyền cảm hứng
inspired 	(a)	 Đầy cảm hứng, sáng tạo
install 	(v)	 Thành lập, trang bị , cài đạt
installed 	(a)	 Đũa được cài đặt
installer 	(n)	 Người cài đặt, lắp đặt
installment 	(n)	 Sự đặt, bổ nhiệm
institute 	(v	 Thành lập , tổ chức
institution 	(n)	 Học viện, cơ quan giáo dục
institutional 	(a)	 Thuộc về viện
institutor 	(n)	 Giáo viên, người sáng lập
instruction 	(n)	 Sự chỉ dẫn
instructional 	(a)	 Để chỉ dẫn
instructive 	(a)	 Dùng để dạy
instructress 	(n)	 Cô giáo
instrument 	(n)	 Dụng cụ, phương tiện
instrumental 	(a)	 Dụng cụ
instrumentalist 	(n)	 Nhạc công
instuctor 	(n)	 Giảng viên giáo viên (nam )
intellience 	(n)	 Sự thông minh
intelligent 	(a)	 Thông minh
intelligently 	(adv)	 Thật thông minh
intend 	(v)	 Dự định, có ý muốn
intended 	(a)	 Có ý định
intent 	(a)	 Có ý , ý định
intentional 	(a)	 Có ý định , chú ý
intently 	(adv)	 Cố ý
interact 	(v)	 Cầu nối, tác dụng qua lại
interaction 	(n)	 Sự hợp tác, tương tác
interactive 	(a)	 Tương giao
interesiting 	(a)	 Hấp dẫn, thú vị
interest 	(n	 Quan tâm, chú ý
interested 	(	 (a) Quan tâm
interestedly 	(adv)	 Đáng quan tâm
interestingly 	(adv)	 Thật thú vị
intermediate 	(a)	 Trung cấp, trung bình
intermediation 	(n)	 Sự trung gian, môi giới
intermediator 	(n)	 Người trung gian
intermedium 	(n)	 Vật ở giữa
international 	(a)	 Thuộc về quốc tế
internationale 	(n)	 Quốc tế ca
internationlism 	(n)	 Chủ nghĩa quốc tê
internationlist 	(n)	 Người theo chủ nghĩa quốc tế
internationlize 	(v)	 Quốc tế hóa
interview 	(v)	 Phỏng vấn
interviewee 	(n)	 Người bị phỏng vấ
interviewer 	(n)	 Người phỏng vấn
introduce 	(v)	 Giới thiệu
introducer 	(n)	 Người giới thiệu
introduction 	(n)	 Sự giới thiệu
introductive 	(a)	 Có tính dẫn nhập
introductory 	(a)	 Dùng để giới thiệu
intruct 	(v)	 Chỉ dẫn, đào tạo, ra lệnh
invalid 	(a)	 Không còn hiệu lực, hết hạn
invalid 	(v	 Bị loại, tàn tật
invalidate 	(v)	 Làm cho mất hiệu lực
invalidation 	(n)	 Sự làm cho mất hiệu lực
invalidity 	(n)	 tnh vô hiệu, hết hiệu lực
invent 	(v)	 Phát minh
invention 	(n)	 Sự phát minh
inventor 	(n)	 Nhà phát minh
invitation 	(n)	 Lời mời
invite 	(v)	 Mời
inviter 	(n)	 Người mời
israel 	(n)	 Nước Irasel
israelite 	(a	 Người Israel
israelitish 	(a)	 Thuộc về Israel
itinerant 	(a)	 Lang thang , du mục
itinerary 	(n)	 Cuộc hành trình, lộ trình
itinerate 	(v)	 Đi chỗ này chỗ khác
itineration 	(n)	 Hành trình, lộ trình
japan 	(n)	 Nước Nhật
japanese 	(a	 Người Nhật, tiếng Nhật
japanesque 	(a)	 Theo kiểu Nhật
jewel 	(n)	 Đá quý, ngọc
jewel 	(v)	 Làm đá quý
jeweler 	(n)	 Thợ kim hoàng
jewelry  		 Đồ nữ trang, châu báu
jewess 	(n)	 Người đàn bà Do Thái
jewish 	(a)	 Tuộc về dân Do Thái
jewry 	(n)	 Khu Do Thái
joke 	(v)	 Nói đùa, giễu cợt
joker 	(n)	 Người hay đùa
jokey 	(a)	 Vui cười, hay đùa
jollier 	(n)	 Ngày hay đuaa
jollify 	(v)	 Làm cho vui vẻ
jolliness 	(n)	 Tánh vui vẻ
jollity 	(n)	 Vui ẻ , khoan khoái
jolly 	(v)	 Chế giễu, đùa cợt
journalism 	(n)	 Nghể làm báo
journalist 	(n)	 Nhà báo, ký giả , phóng viên
journalistic 	(a)	 Thuộc về báo chí
journalize 	(v)	 Veit báo
joy 	(v)	 Tỏ ra vui mừng, hân hoan
joyful 	(a)	 Vui mừng, vui vẻ
joyfully 	(adv)	  Thật vui mừng 
joyfulness 	(n)	 Sự vui mừng
juice 	(n	 Nước trái cây , ép nước
juicily ≠ juiceless 	≠	 Có thật nhiều nước ≠ không
juicy 	(a)	 Có nhiều nước
jumble 	(v)	 Làm lộn xộn
jumbly 	(a)	 Hỗn độn
jungle 	(n)	 Rừng rậm
jungly 	(a)	 Thuộc về rừng
keen 	(a)	 Hăng hái, say mê, ham thích
keeness 	(n)	 Sự hăng hái, say mê
keenly 	(adv)	 Nhiệt tình , hăng hái
kind 	(a)	 Tử tế, tốt bụng
kindly 	(adv)	 Thật tử tế
kindness  		 Sự tốt bụng 
know 	(v)	 Hiểu biết
knowing 	(a)	 Hiểu biết, thành thạo
knowingly 	(adv)	 Tính khôn ,lanh lẹ
knowledge 	(n)	 Hiểu biết , sự hiểu biết
knownable 	(a)	 Có thể hiểu biết
label 	(n	 Nhãn hiệu, dán nhãn
labeller 	(n)	 Người dán nhãn
large 	(a)	 Rộng lớn
largely 	(adv)	 Thật rộng lớn
largeness 	(n)	 Sự rộng lớn
late 	(a)	 Trể , muộn
late 	(adv)	 Trễ muộn
lately 	(adv)	 Gàn đây, mới vừa
lateness 	(n)	 Sự trễ
laugh 	(v	 Cười , nực cười
laughable 	(a)	 Tức cười, nực cười
laugher 	(n)	 Người hay cười
laughing 	(a)	 Hay cười, cười vui vẻ
laughter 	(n)	 Tiếng cười
law 	(n)	 Luật lệ ,phép tắc
lawful 	(a)	 Hợp pháp , đúng luật
lawfully 	(adv)	 Đúng luật
lawyer 	(n)	 Luật sư 
lazily 	(adv)	 Thật lười biếng
laziness 	(n)	 Sự lười biếng
lazy 	(a)	 Lười biếng
lead 	(v)	 Lãnh đạ, hướng dẫn
leader 	(n)	 Người lãnh đạo
leaderless 	(a)	 Không có người cầm dầu
leadership 	(n)	 Sự chỉ huy, hướng dẫn
leading 	(n)	 Sự lãnh đạo , chỉ huy
leak 	(v	 Rò rỉ, thấm nước
leakage 	(n)	 Sự rò rỉ, thấm qua
leakiness 	(n)	 Tình trạng dột
leaky 	(a)	 Chảy, dột, rỉ ra
learn 	(v)	 Học tập, nghiên cứu
learned 	(a)	 Có học thức
learnedly 	(adv)	 Tinh thông , uyên bác
learner 	(n)	 Người học
learning 	(n)	 Sự học
leisure 	(n)	 Thì giờ rãnh rỗi
leisured 	(a)	 Nhàn hạ
leisurely 	(adv	 Thong tả, nhàn rỗi
lenghten 	(v)	 Làm cho dài ra
length 	(n)	 Chiều dài, độ dài
lengthily 	(adv)	 Dài dòng , lê thê
lengthy 	(a)	 Dài dòng, buồn chán
libertarian 	(n)	 Người theo chủ nghĩa tự do
libertinism 	(n)	 Tư tưởng tự do
liberty 	(n)	 Sự tự do, quyền tự do
librarian 	(n)	 Người giữ thư viện
library 	(n)	 Thư viện
life 	(n)	 Cuộc đời, cuộc sống
life 	(n)	 Cuộc sống
light 	(n	 Ánh sáng , sáng , nhẹ
light 	(v)	 Thắp sáng, đốt đèn
lighten 	(v)	 Làm cho nhẹ đi, làm sáng
lighter  		 Người thắp đèn,bật lửa 
limit 	(v)	 Hạn chế, giới hạn
limitary 	(a)	 Bị hạn chế, giới hạn
limitation 	(n)	 Sự hạn chế, giới thiệu
limited 	(a)	 Có hạn, hữu hạn
limiting 	(a)	 Hạn chế , hạn định
limitless 	(a)	 Vô hạn định
liquid 	(a)	 Lỏng , chảy ra
liquid 	(n)	 Chất lỏng, chất nước
liquidity 	(n)	 Trạng thái nước lỏng
liquifaction 	(n)	 Sự hóa lỏng
liquify 	(v)	 Làm hóa lỏng
liquor 	(n)	 Rược mạnh, thuốc rượu
liquor 	(v)	 Uống rượu
liquorish 	(a)	 Thích uống rượu
listen 	(v)	 Nghe
listening 	(n)	 Sự nghe
listenr 	(n)	 Người nghe
literacy 	(n)	 Sự có học, biết đọc, biết chữ
literate 	(a)	 Có học, biết chữ
literati 	(n)	 Giới trí thức, văn sĩ
literator 	(n)	 Nhà văn
literature 	(n)	 Văn chương
live 	(a)	 Trực tiếp
live 	(a)	 Trực tiếp, còn sống
live 	(v)	 Sống
live 	(v)	 Sống , ở
liveable 	(a)	 Có thẻ ở được
liveliness 	(n)	 Sự hăng hái , lah lợi
lively 	(a)	 Sống động ,đầy sinh khí
lively 	(adv)	 Sinh động
liver 	(n)	 Người sống
living 	(n)	 Sự sống
local 	(a)	 Đại phương
locality 	(n)	 Chỗ, địa phương
localize 	(v)	 Sự xác định phương hướng
locally 	(adv)	 Liên hệ tới đại phương
lock 	(v	 Khóa, đóng
locker  		 Tủ có khóa 
logic 	(n)	 Luận lý học
logical 	(a)	 Hợp với luận lí, hợp lý
logically 	(adv)	 Một cách hợp lý
logician 	(n)	 Nhà luận lý học
logicize 	(v)	 Hợp lý hóa
logistics 	(n)	 Khoa luận lý học
long 	(a)	 Dài
loose 	(a)	 Lỏng lẻo , rộng ra
loose 	(n)	 Sự buông lỏng
loose  		 Mở , cởi, tháo ra
loosely 	(adv)	 Một cách lỏng lẻo, rời rạc
loosener 	(n)	 Người mở, người cởi
looseness 	(n)	 Sự long ra, quá rộng
loud 	(a)	 To , ầm ĩ
loudly 	(adv)	 Thật ầm ĩ
loudness 	(n)	 Sự ồn
love 	(n	 Yêu ,tình yêu
loveless 	(a)	 Không dễ thương
lovely 	(a)	 Dễ thương ,xinh
lover 	(n)	 Người yêu
lovesick 	(a)	 Tương tự
low 	(a)	 Dưới thấp
lower 	(v)	 Hạ thấp, giảm xuống
lowerable 	(a)	 Có thể hạ thấp được
lowermost 	(a)	 Thấp nhất
lowly 	(adv)	 Tầm thường, ti tiện
lowness 	(n)	 Tự thấp
luck 	(n)	 Sự may mắn
luckily 	(adv)	 Thât may mắn
lucky 	(a)	 May mắn
luxuriate 	(v)	 Xa xỉ, xa hoa , lộng lẫy M
luxurious 	(a)	 Lộng lẫy , sang trọng
luxury 	(n)	 Sự xa hoa, lộng lẫy
machine 	(n)	 Máy móc
machinery 	(n)	 Máy móc gọi chung
machinist 	(n)	 Nhà chế tạo máy móc
magic 	(n)	 Ma thuật, ảo thuật
magic 	(v)	 Làm ảo thuật
magical 	(a)	 Thần diệu, kỳ diệu
magically 	(adv)	 Một cách ảo thuật
magician 	(n)	 Nhà ảo thuật, phù thủy
magnificence 	(n)	 Sự lộng lẫy, nguy nga
magnificent 	(a)	 Lộng lẫy, nguy nga
mail 	(n)	 Thư từ, bưu điện
mail 	(v)	 Gửi bằng bưu điện
mailable 	(a)	 Có thể gửi đi bằng thư
mailman 	(n)	 Người đưa thư
maintain 	(v)	 Chính yếu, chủ yếu
maintainable 	(a)	 Chính , chủ yếu
maintainance 	(n)	 Duy trì, bảo quản, cung cấp
maintainer 	(n)	 Thật chính yếu
major 	(a)	 Lớn, trọng đại, chính yếu
majority 	(n)	 Phần đông ,đa số
manage 	(v)	 Có tính đàn ông
management 	(n)	 Nhân tính
manager 	(n)	 Quản lý
manageress 	(n)	 Sự quản lý
manhood 	(n)	 Loài người
mankind 	(n)	 Loài người
manly 	(a)	 Con người, đàn ông
marriage 	(n)	 Giám đốc ( nữ )
married 	(a)	 Kết hôn ,gả con
marry 	(v)	 Giám đốc ( nam )
marvel 	(n)	 Kỳ diệu, tuyệt diệu, ngạc nhiên
marvel 	(v)	 Thuộc về vợ chồng, hôn lễ
marvellous 	(a)	 Lễ cưới, sự kết hôn
material 	(a)	 Vật chất, vật liệu, vải
material 	(n)	 Lấy làm ngạc nhiên
materialist 	(n)	 Mang hình thức vật chất
materialize 	(v)	 Một cách thiết yếu
materially 	(adv)	 Nguyên vật liệu xây dựng
materials 	(n)	 Kì quan, phi thường
mathematical 	(a)	 Môn toán
mathematician 	(n)	 Thuộc về toán học
mathematics  		 Người theo chủ nghĩa vật chất
mathematize 	(v)	 Nhà toán học
mean 	(v)	 Toán học hóa
meaning 	(n)	 Ý nghĩa
meaningful 	(a)	 Đầy ý nghĩa
meaningless 	(n)	 Vô nghĩa
meaningly 	(adv)	 Đầy ý nghĩa
means 	(n)	 Phương tiện
measure 	(v)	 Đo lường
measurement 	(n)	 Sự đo lường
mechanic 	(n)	 Thợ máy
mechanical 	(a)	 Thuộc cơ khí
mechanics 	(n)	 Cơ học
mechanize 	(v)	 Cơ khí hóa
medical 	(a)	 Thuộc về y học
medical 	(n)	 Sự khám sức khỏe
medically 	(adv)	 Khỏe mạnh
medicare 	(n)	 Sự chăm sóc đặc biệt
medicate 	(v)	 Cho uống thuốc, trị bịnh
medicine 	(n)	 Thuốc
medin 	(n)	 Phương tiện truyền thông
meet 	(a)	 Thích đáng
meet 	(v)	 Gặp gỡ
meeting 	(n)	 Sự gặp gỡ, cuộc họp
meetly 	(adv)	 Một cách thích đáng
memorial 	(a)	 Kỉ niệm
memorial 	(n)	 Đài tưởng niệm
memorialize 	(v)	 Làm lễ kỉ niệm
memorize 	(v)	 Ghi nhớ, thuộc lòng
memory 	(n)	 Trí nhớ , kỉ niệm
mention 	(v)	 Nhắc tới, đề cập
mentioned 	(a)	 Đã nói, đã đề cập
meteor 	(n)	 Khí tượng, sao băng
meteorologist 	(n)	 Nhà khí tượng học
meteorology 	(n)	 Khoa khí tượng học
meterograph 	(n)	 Khí tượng kế
meteroic 	(a)	 Thuộc về khí tượng, sao băng
microoganism 	(n)	 Vi sinh vật
microorganic 	(a)	 Thuộc về vi sinh vật
migrant 	(a)	 Di cư, di trú
migrant 	(n)	 Người di tản, di trú
migrate 	(v)	 Di trú, di cư
migration 	(n)	 Sự di trú
migrator 	(n)	 Nguời di tản, chim di trú
migratory 	(a)	 Có thói quen di trú
mind 	(n)	 Tâm trí, tinh thần
mindful 	(a)	 Lưu tâm
mindfulness ≠ mindless 	≠	 Sự lưu tâm ≠ Không lưu tâm
mindlessly 	(adv)	 Thiếu suy xét
mineral 	(n)	 Khoáng vật, khoáng chất
mineralize 	(v)	 Khoáng hóa
mineralizer 	(n)	 Chất khoáng hóa
mineralogist 	(n)	 Nhà khoáng vật học
mineralogy 	(n)	 Khoa khoáng vật học
minimal 	(a)	 Nhỏ, li ti
minimize 	(v)	 Thu nhỏ
minimum 	(a)	 Một chút xíu, mức tối thiểu
minor 	(a)	 Nhỏ hơn ,bé hơn
minority 	(n)	 Thiểu số
miracle 	(n)	 Sự kỳ lạ, kỳ diệu
miraculous 	(a)	 Thần diệu, phi thường
miraculously 	(adv)	  cách kỳ diệu
misunderstand 	(v)	 Hiểu nhầm
mix 	(v)	 Trộn , pha trộn
mixable 	(a)	 Có thể pha trộn
mixed 	(a)	 Lẫn lộn, hỗn hợp
mixer 	(n)	 Máy nhồi, máy trộn
mixture 	(n)	 Sự pha trộn
moderate 	(a)	 Vừa phải, điều độ
moderately 	(adv)	 Thật điều độ
moderation 	(n)	 Sự điều độ
modern 	(a)	 Hiện đại
modern 	(n)	 Sự hiện đại
modernise 	(v)	 Hiện đại hóa
modernly 	(adv)	 Thật hiện đại
modest 	(a)	 Khiêm tốn
modesty 	(n)	 Sự khiêm tốn
month 	(n)	 Tháng
monthly 	(a	 Hàng tháng
moon 	(n)	 Mặt trăng
moonlight 	(n)	 Ánh trăng
moony  		 Có trăng
mother 	(n)	 Người mẹ
motherhood  		 Tình mẹ
motherly 	(a)	 Có tình mẹ, như mẹ
mountain 	(n)	 Núi
mountaineer 	(n)	 Dân miền úi
mountaineering 	(n)	 Môn leo núi
mountainous 	(a)	 Cao to như núi, có nhiều núi
movability  		 Tính hay di động 
movable 	(a)	 Lưu động
move 	(v)	 Di chuyển
movement 	(n)	 Sự di dời, phong trào
mpure 	(a)	 Không trong lành
music 	(n)	 Âm nhạc
musical 	(a)	 Thuộc về âm nhạc
musician 	(n)	 Nhạc sĩ
mysterious 	(a)	 Thần kỳ , huyền bí, bí mật
mysteriously 	(adv)	 Một cách bí mật
mysteriousness 	(n)	 Sự thần bí
mystery 	(n)	 Điều bí mật, mầu nhiệm
name 	(n)	 Tên
namely  		 Chỉ tên
narrow 	(a)	 Hẹp
narrowly 	(adv)	 Thật hẹp
nation 	(n)	 Nước, dân tộc, quốc gia
national 	(a)	 Thuộc về dân tộc, quốc gia
nationality 	(n)	 Quốc tịch
nationalization 	(n)	 Sự nhập quốc tịch
nationally 	(adv)	 Toàn quốc
nationlist 	(n)	 Người theo CN dân tộc
nationlize 	(v)	 Nhập quốc tịch
native 	(n	 Quê quán, người bản xứ
natively 	(adv)	 Bản xứ, nơi sinh
nativity 	(n)	 Sự sinh đẻ, sinh nhật
natural 	(a)	 Thuộc về thiên nhiên
naturalize 	(v)	 Tự nhiên hóa
naturally 	(adv)	 Thật tự nhiên
nature 	(n)	 Tự nhiên
near 	(a)	 Gần
nearly 	(adv)	 Rất gần
nearness 	(n)	 Sự gần gũi
neceesitate 	(v)	 Bắt buộc phải
necessarily 	(adv)	 Tất yếu
necessary 	(a)	 Cần thiết
necessity 	(n)	 Sự cần thiết
neglect 	(n	 Sự xao lãng
neglected 	(a)	 Lôi thôi , lếch thếch
neglectful 	(a)	 Xao lãng, cẩu thả
neglectfully 	(adv)	 Thật cẩu thả
neighbor 	(n)	 Người hàng xóm
neighborhood 	(n)	 Vùng lân cận
nerve 	(v)	 Kích thích, khuyến khích
nervous 	(a)	 Lo lắng, bị kích đọng
nervously 	(adv)	 Bồn chồn, lo lắng
nervousness 	(n)	 Sự lo lắng
new 	(a)	 Mới
newly 	(adv)	 Thật mới
newness 	(n)	 Sự mới mẻ
noise 	(n)	 Tiếng ồn
noiselessly 	(adv)	 Thật vắng lặng
noisily 	(adv)	 Thật ồn ào
noisiness 	(n)	 Sự ồn ào
noisy 	(a)	 ồn ào
nominate 	(v)	 Tiến cử, bầu , chọn , kêu tên
nomination 	(n)	 Sự chỉ định, bổ nhiệm
nominative 	(a)	 Được bổ nhiệm, được bầu
nominator 	(n)	 Người bổ nhiệm
nominee 	(n)	 Người được bổ nhiệm
normal 	(a	 Bình thường, thông thường
normalize 	(v)	 Bình thường hóa
normally 	(adv)	 Thông thường
north 	(a)	 Hướng về phương Bắc
north 	(n)	 Phương Bắc
northern 	(a)	 Thuộc về phương Bắc
northerner 	(n)	 Người sống ở phương Bắc
observation 	(n)	 Sự quan sát
observe 	(v)	 Quan sát
observer 	(n)	 Người quan sát
occur 	(v)	 Xảy ra, xảy đến
occurrence 	(n)	 Biến cố , việc xảy ra
ocean 	(n)	 Biển , đại dương
oceanian 	(a)	 Thuộc về châu đại dương
oceanic 	(a)	 Thuộc về đại dương
oceanographer 	(n)	 Nhà hải dương học
oceanography 	(n)	 Hải dương học
offer 	(v)	 Biếu , tặng , cho , hiến
offering 	(n)	 Quà tặng, quà biếu
offertory 	(n)	 Sự quyên tiền
offically 	(adv)	 Chính thức, trịnh trọng
office 	(n)	 Văn phòng , trụ sở , cơ quan
officer 	(n)	 Nhân viên ,công chức
official 	(a)	 Chính thức, trịnh trọng
officialdom 	(n)	 Giới công chức
officialese 	(n)	 Giấy tờ công văn
officilaize 	(v)	 Chính thức hóa
old 	(a)	 Cũ, già, cổ xưa, tuổi
olden 	(a)	 Ngày xưa, thưở xưa
olden 	(v)	 Làm cho già đi
open 	(v)	 Mở, khai mạc
opener 	(n)	 Người mở
opening 	(n	 Khai mạc, phần đầu
openly 	(adv)	 Cơng khai
oral 	(a)	 Bằng lời nói, bằng miệng
oral 	(n)	 Kì thi vấn đáp
orally 	(adv)	 Bằng miệng
orbit 	(v	 Đi theo quỹ đạo, quỹ đạo
orbital 	(a)	 Thuộc về quỹ đạo
order 	(v)	 Ra lệnh, gọi, khuyên bảo
ordered 	(a)	 Khéo sắp xếp
orderliness ≠ olderless 	≠	 Sự ngăn nắp ≠ không trật tự
orderly 	(a)	 Có thứ tự, ngăn nắp
organizable 	(a)	 Có thể tổ chức được
organization 	(n)	 Tổ chức, cơ cấu
organize 	(v)	 Tổ chức
organizer 	(n)	 Người tổ chức
orginative 	(a)	 Khởi thủy , độc đáo
orginator 	(n)	 Người sáng tạo, bắt đầu
orhanage 	(n)	 Cô nhi viện
origin 	(n)	 Nguồn gốc, căn nguyên
original 	(a)	 Nguyên thủy
originality 	(n)	 Tính chất nguồn gốc
originally 	(adv)	 Đầu tiên, sơ khai
originate 	(v)	 Khơi thủy, bắt nguồn
origination 	(n)	 Sự bắt nguồn
orphan 	(n)	 Cô nhi, trẻ mồ côi
orphaned 	(a)	 Mồ ôi
overcrowd 	(v)	 Làm cho quá đông
overcrowded 	(a)	 Quá đông
own 	(v)	 Làm chủ
owner 	(n)	 Người chủ
ownership  		 Quyền sở hữu 
paddle 	(n)	 Máy chèo bản to
paddle 	(v)	 Chèo, bơi , lội nước
paddler 	(n)	 Người chèo xuồng
pain 	(n	 Sự đau nhức, làm đau
painful 	(a)	 Đau
painfully 	(adv)	 Thật đau 
paint 	(n	 Nước sơn , sơn
painter 	(n)	 Thợ sơn nam, họa si
painting 	(n)	 Bức họa
paintress 	(n)	 Nữ họa sĩ
painty 	(a)	 Có sơn
park 	(n)	 Công viên ,chỗ đậu xe
park 	(v)	 Đậu xe vào bãi
parking 	(n)	 Sự đậu xe, bãi đậu
participant 	(n)	 Người tham gia
participate 	(v)	 Tham gia vào
participation 	(n)	 Sự tham gia vào
patience  		 Sự kiên nhẫn
patient 	(n)	 Kiên nhẫn
patinetly 	(adv)	 Thật kiên nhẫ
peace 	(n)	 Hòa bình
peaceful 	(a)	 Hòa bình, thanh bình
peacefully 	(adv)	 Thật thanh bình
percaution 	(n)	 Sự cẩn thận ,đề phòng
perfect 	(a)	 Hoàn hảo, chính xác
perfect 	(v)	 Hoàn thành, thành thạo
perfection 	(n)	 Sự hoàn thiện, hoàn hảo
perfective 	(a)	 Đề làm cho hoàn thiện
perfectly 	(adv)	 Thật hoàn hảo, chính xác
perform 	(v)	 Thực hiện , trình diễn
performable 	(a)	 Có thể thi hành
performance 	(n)	 Màn trình diễn
performer 	(n)	 Người biểu diễn
permanence 	(n)	 Sự vĩnh cữu
permanent 	(a)	 Thường xuyên , luôn luôn
permanently 	(adv)	 Có tính thường xuyên
permission 	(n)	 Sự cho phép
permissive 	(a)	 Chấp nhận
permit 	(v)	 Cho phép
person 	(n)	 Người
personal 	(a)	 Cá nhân ,riêng tư
personalize 	(v)	 Cá nhân hóa
personally 	(adv)	 Đích thân , bản thân
personlaity 	(n)	 Nhân ách
persuade 	(v)	 Thuyết phục, làm cho tin
persuader 	(n)	 Người tn theo
persuasible 	(a)	 Có thể làm cho tin
persuasion 	(n)	 Sự thuyết phục
persuasive 	(a)	 Dễ tin, dễ thuyết phục
pessimism 	(n)	 Tính bi quan
pessimist 	(n)	 Người bi quan
pessimistic 	(a)	 Bi quan
photograph 	(n)	 Bức hình, bức ảnh
photograph 	(v)	 Chụp hình, chụp ảnh
photographer 	(n)	 Thợ chụp ảnh
photographic 	(a)	 Thuộc về nhiếp ảnh
photography 	(n)	 Nghệ thuật nhiếp ảnh
physical 	(a)	 Thuộc về vật lý
physically 	(adv)	 Về phương diện vật lý
physicist 	(n)	 Nhà vật lý
physics 	(n)	 Vật lý
plain 	(a)	 Rõ ràng , minh bạch ,đơn
plainess 	(n)	 Sự bình dị, rõ ràng
plainly 	(adv)	 Rõ ràng, giản dị, thẳng thắn
plastic 	(a)	 Mềm dẻo, bằng nhựa
plastic 	(n)	 Chất dẻo
plasticity 	(n)	 Tính déo, uốnn ắn dược
plasticize 	(v)	 Làm cho dẻo
platicine 	(n)	 Chất dẻo nhân tạo
play 	(n)	 Kịch
play 	(v)	 Chơi, thi đấu
player 	(n)	 Người chơi, cầu thủ
pleasant 	(a)	 Vui vẻ, sảng khoái
pleasantly  		 Thật dễ chịu
please 	(v)	 Làm hài lòng
pleased 	(a)	 Hài lòng
pleasure 	(n)	 Sự hài lòng
plentiful 	(a)	 Phong phú, dư thừa
plentifully 	(adv)	 Thật phong phú
plenty 	(n)	 Nhiều, phong phú
plumb 	(n)	 Cục chì, dây chì, thẳng đứng
plumbago 	(n)	 Than chì
plumber 	(n)	 Thợ hàn ống nước,hàn chì
plumbery 	(n)	 Xưởng, nghề đúc hàn chì
plumbing 	(n)	 Hệ thống ống nước
plumbous 	(a)	 Có chất chì
poem 	(n)	 Bài thơ
poet 	(n)	 Nhà thơ , thi sĩ (nam)
poetess 	(n)	 Nữ thi sĩ
poetic 	(a)	 Có ý thơ, thuộc về thi ca
poetically 	(adv)	 Một cách nên thơ
poeticize 	(v)	 Biến thành thơ
poetize 	(v)	 Làm thơ
poetry 	(n)	 Nghệ thuật làm thơ, thi ca
point 	(n)	 Điểm, chấm, vấn đề, mũi
point 	(v)	 Làm dấu, hướng về mũi nhọn
pointed 	(a)	 Có đầu nhọn, nhọn , sắc sảo
pointer 	(n)	 Kim đồng hồ, que
pointless 	(a)	 Không bén nhọn, vô nghĩa
pointlessly 	(adv)	 Thật vô nghĩa
poison 	(n	 Thuốc độc, chất độc, bỏ độc
poisoned 	(a)	 Bị nhiễm độc
poisoner 	(n)	 Người bỏ thuốc độc
poisonous 	(a)	 Có độc, nọc độc, độc hịa
polite 	(a)	 Lịch sự, lễ phép
politely 	(adv)	 Thật lễ phép
politeness ≠ impolite 	≠	 Sự lễ phép ≠ Bất lịch sự
pollutant 	(n)	 Chất gây ô nhiễm
pollute 	(v)	 Làm ô nhiễm
polluted 	(a)	 Bị ô nhiễm
pollution 	(n)	 Sự ô nhiễm
poor 	(a)	 Ngèo, tội nghiệp, thiếu thốn
poorly 	(adv)	 Thiếu thốn, thật tội nghiệp
popular 	(a)	 Phổ biến
popularity 	(n)	 Sự phổ biến
popularize 	(v)	 Làm cho phổ biến
popularly 	(adv)	 Thật phổ biến
populate 	(v)	 Đem dân đến ở
population 	(n)	 Dân số, quần chúng, nhân dân
populous 	(a)	 Đông dân cư
populousness 	(n)	 Sự đông dân cư
posioning 	(n)	 Sự làm truyền nhiễm độc
posionously 	(adv)	 Thật độc hại
positive 	(a)	 Chắc chắn, tích cực, tuyệt đối
positively 	(adv)	 Thật, quả quyết, tích cực
positiveness 	(n)	 Tích xác thực, tích cực
possibility 	(n)	 Có khả năg
possible 	(a)	 Có thể
possibly  		 Thật có thể 
pour 	(n)	 Trận mưa rào
pour 	(v)	 Đổ , trút , rót, mưa rào
pouring 	(a)	 Như trút nước
poverty 	(n	 Sự nghèo túng
power 	(n)	 Quyền lực, sức mạnh
powerful 	(a)	 Hùng mạnh , có lực
powerfully 	(adv)	 Thật mạnh mẽ
powerless 	(a)	 Bất lực, yếu đuối
powerlessly 	(adv)	 Thật yếu đuối
practical 	(a)	 Thuộc vè thực tập, thực tiễn
practicality 	(n)	 Sự thực tế
practically 	(adv)	 Thực tiễn , thiết thực
practice 	(n)	 Sự luyện tập, thực hành
practise 	(v)	 Thực tập, thực hành
pray 	(v)	 Cầu nguyện, thỉnh cầu
prayer 	(n)	 Người cầu nguyện, lễ cầu kinh
precautionary 	(a)	 Cẩn thận ,đề phòng
precious 	(a)	 Quý giá, vô giá, cầu kỳ
preciously 	(adv)	 Thật kiểu cách, cầu kỳ , quý
preciousness 	(n)	 Sự quý giá
predict 	(v)	 Tiên đoán ,dự đoán
predictable 	(a)	 Có thể đoán trước
prediction 	(n)	 Sự tiên đoán, điềm báo
predictive 	(a)	 Đoán trước, dự đoán
predictor 	(n)	 Nhà tiên tri, tiên đoán
preparation 	(n)	 Sự sắp đặt, chuẩn bị
preparative 	(a)	 Dự bị, chuẩn bị trước
preparatory 	(a)	 Sửa soạn trước, có sẵn
prepare 	(v)	 Chuẩn bị , sắp đặt
preservable 	(a)	 Có thể bảo tồn được
preservation 	(n)	 Sự bảo tồn
preservative 	(a)	 Duy trì, bảo tồn
preserve 	(v)	 Giữ gìn, bảo tồn, duy trì
preserver 	(n)	 Người bảo tồn, giữ gìn
pressurage 	(n)	 Sự ép
pressure 	(n)	 Áp lực, áp suất, sức ép
pressurize 	(v)	 Gây áp lực, sức ép
prettify 	(v)	 Trang điểm, làm dáng
prettily 	(adv)	 Thật xinh xắn
prettiness 	(n)	 Vẻ xinh xắn
pretty 	(a)	 Dễ thương,xinh xắn
prevent 	(v)	 Ngăn chặn
prevention 	(n)	 Sự ngăn chặn
pride 	(n)	 Sự tự hào
print 	(n)	 Chữ in , sự in ra
print 	(v)	 In ấn
printable 	(a)	 Có thể in được
printer 	(n)	 Máy in, thợ in
printery 	(n)	 Nhà in, chỗ in bông
printing 	(n)	 Việc in, xuất bản, nghề in
printless 	(a)	 Không để lại dấu vết
prison 	(n)	 Nhà tù
prisoner 	(n)	 Tù nhân
probability 	(n)	 Sự có thể xảy ra
probable 	(a)	 Có thể , có khả năng
probably 	(adv)	 Thật có thể
procedural 	(a)	 Thuộc về thủ tục
procedure 	(n)	 Cách thức, đường lối
process 	(n)	 Diễn biến, quá trình
process 	(v)	 Chế biến, xử lý
procession 	(n)	 Sự diễn tiến
processor 	(n)	 Máy chế biến
produce 	(v)	 Sản xuất
producer 	(n)	 Nhà sản xuất
produciton 	(n)	 Sự sản xuất, sản lượng
product 	(n)	 Sản phẩm
productive 	(a)	 Sản xuất, sinh lợi
productively 	(adv)	 Một cách hiệu quả, sinh lợi
profeesion 	(n)	 Nghề nghiệp
profess 	(v)	 Bày tỏ, biểu lộ, dạy học
professional 	(a)	 Chuyên nghiệp
professionalize 	(v)	 Chuyên nghiệp hóa
professionally 	(adv)	 Thật chuyên nghiệp
professor 	(n)	 Giáo sư
proficiency 	(n)	 Khả năng ,năng lực
proficient 	(a)	 Có tài, khéo léo, tinh thông
proficiently 	(adv)	 Thật khéo léo
program 	(n)	 Chương trình
program 	(v)	 Lập chương trình
programmer 	(n)	 Lập trình viên
prohibit 	(v)	 Cấm , ngăn chặn
prohibition 	(n)	 Sự ngăn cấm
prohibitive 	(a)	 Ngăn cấm
prohibitor 	(n)	 Người cấm
promisce 	(n)	 Người được hứa hẹn
promise 	(v	 Hứa hẹn , lời hứa
promised 	(a)	 Ước hẹn , đã hứa
promising 	(a)	 Đầy hứa hẹn, hy vọng
promissory 	(a)	 Hứa hẹn
proper 	(a)	 Đúng , thích hợp
properly 	(adv)	 Thật chính xác, hợp lý
protect 	(v)	 Bảo vệ , che chở
protection 	(n)	 Sự bảo vệ
protective 	(a)	 Bảo vệ, che chở
protector 	(n)	 Người bảo vệ
proudly 	(adv)	 Thật tự hào
pround 	(a)	 Tự hào, hãnh diện
prounounce 	(v)	 Phát âm, tuyên bố
prounounceable 	(a)	 Có thể phát âm được
prounounced 	(a)	 Rõ ràng, xác định được
prounouncement 	(n)	 Sự tuyên bố
prounounciation 	(n)	 Sự phát âm
provide 	(v)	 Cung cấp, dự phòng
providence 	(n)	 Sự dự phòng
provident 	(a)	 Biết dự phòng trước
provider 	(n)	 Nhà cung cấp
public 	(a)	 Công cộng, chung , công khai
public 	(n)	 Quần chúng
publication 	(n)	 Sự công bố
publicity 	(n)	 Tính công khai
publicize 	(v)	 Công khai
publicly 	(adv)	 Một cách công khai
publish 	(v)	 Truyền bá, xuất bản
published 	(a)	 Được xuất bản
publisher 	(n)	 Nhà xuất bản
publishing 	(n)	 Nghề nghiệp , việc xuất bản
pump 	(v)	 Bơm phồng lên
pumped 	(a)	 Hết hơi
pure 	(a)	 Trong lành trong sạch
purely 	(adv)	 Chỉ là, hoàn toàn
pureness 	(n)	 Sự tinh khiết, trong lành
puring 	(n)	 Sự đổ trút
purpose 	(n)	 Mục đích, kết quả
purpose 	(v)	 Dự định
purposeful 	(a)	 Có mục đích, ý định
purposefully 	(adv)	 Một cách cương quyết
purposeless 	(a)	 Không có mục đích
purposely 	(adv)	 Chủ ý chủ tâm
qualifer 	(n)	 Người đủ năng lực
qualification 	(n)	 Khả năng
qualified 	(a)	 Có đủ năng lực
qualify 	(v)	 Có đủ tài năng
quality 	(n)	 Tính chất, phẩm chất
question 	(n)	 Câu hỏi
question 	(v)	 Chất vấ
questionable 	(v)	 Nghi ngờ
questioner 	(a)	 Người hỏi, người chất vấn
questioning 	(a)	 Tra hỏi, chất vấn
questioningly 	(adv)	 Dò hỏi  cách nghi ngờ
questionless 	(a)	 Không nghi ngờ
questionnaire 	(n)	 Bản in câu hỏi
quick 	(a)	 nhanh , gấp
quickly 	(adv)	 Thật nhan
quickness 	(n)	 Sự nhanh chóng
quickon 	(v)	 Làm lãng nhan
quiet 	(a)	 Yên tịnh, yên lặng
quieten 	(v)	 Làm cho yên lặng
quietly 	(adv)	 Thật yên lặng
quietness 	(n)	 Sự yên tịnh R
rain 	(v	 Mưa, trời mưa
rainless 	(a)	 Không mưa
rainy 	(a)	 Có mưa
rare 	(a)	 Hiếm
rarely 	(adv)	 Hiếm khi
rareness 	(n)	 Sự hiếm có
read 	(v)	 Đọc
reader 	(n)	 Người đọc , sách đọc thêm
readily 	(adv)	 Sẵn sàng
readiness 	(n)	 Sự sẵn sàng
reading 	(n)	 Bài đọc
ready 	(a)	 Sẵn sàng
real 	(a)	 Thật sự
realize 	(v)	 Thực hiện, thực hành, nhận ra
really 	(adv)	 Thật sự
realty 	(n)	 Sự thực
reason 	(n	 Lý do
reasonable 	(a)	 Hợp lý
reasonably 	(adv)	 Thật hợp lý
receivable 	(a)	 Có thể thu được
receive 	(v)	 Nhận, thu được
receiver 	(n)	 Người nhận, ống nghe, điện
receiving 	(n)	 Sự nhận
recency 	(n)	 Tính chất mới gần đây
recent 	(a)	 Gần đây, mới nay
recently 	(adv)	 Gần đây mới đây
recerational 	(a)	 Thuộc về sự giải trí
recipient 	(a)	 Dễ cảm thụ, dễ nhận
recoginizable 	(a)	 Có thể nhận ra
recognition 	(n)	 Sự công nhận
recognize 	(v)	 Công nhận, nhận ra
recognized 	(a)	 Đã được thừa nhận
recreate 	(v)	 Tái tạo lại, lập lại
recreation 	(n)	 Sự nghĩ ngợi, trò giải trí
recreative 	(a)	 Tiêu khiển
recyclable 	(a)	 Thuộc về tái chế
recycle 	(v)	 Tái chế
recycled 	(a)	 Được tái chế
recycling 	(n)	 Việc tái chế
reduce 	(v)	 Cắt giảm, làm bớt đi
reduced 	(a)	 Giảm giá
reducer 	(n)	 Máy thu nhỏ
reducibility 	(n)	 Sự có thể giảm xuống
reducible 	(a)	 Có thể giảm xuống
reduction 	(n)	 Sự cắt giảm , rút bớt
refer 	(v)	 Tham khảo
reference 	(n)	 Sự tham khảo
refine 	(v)	 Tính lọc, cải tiến, giáo dục
refined 	(a)	 Đã tinh chế, có giáo dục
refinement 	(n)	 Sự tinh chế, khéo léo
refiner 	(n)	 Người (máy) tinh chế
refinery 	(n)	 Nhà máy tinh luyện
reflect 	(v)	 Phản chiếu, phản ánh
reflection 	(n)	 Sự phản chiếu, phản ánh
reflective 	(a)	 Phản chiếu, phản ánh
reflector 	(n)	 Gương phản chiếu
refresh 	(v)	 Nghỉ ngơi, làm cho mát
refresher 	(n)	 Thức uống giải khát
refreshing 	(a)	 Khỏe khoắn , dễ chịu
refreshment 	(a)	 Sự nghỉ ngơi , tịnh dưỡng
register 	(v)	 Ghi đăng ký , đảm bảo
registrar 	(n)	 Hộ tịch viên, giám thị
registration 	(n)	 Sự đăng ký
registry 	(n)	 Sự ghi, biên vào sổ
regular 	(a)	 Thường xuyên ,đều
regularly 	(adv)	 Thường xuyên 
relate 	(v)	 Liên hệ, quan hệ
relation 	(n)	 Sự quan hệ, liên hệ
relationship 	(n)	 Mối liên hệ
relative 	(n)	 Bà con, thân thuộc
relative 	(n)	 Người bà con ,cân xứng
relatively 	(adv)	 Thật tương đối
relativity 	(n)	 Sự tương đối
relax 	(v)	 Làm dãn ra, thư dãn
relaxation 	(n)	 Sự thư giãn, giải trí
relaxed 	(a)	 Thư giãn
relaxing 	(a)	 Thư giãn
relief 	(n)	 Sự làm dịu đi,bớt đi
relieve 	(v)	 Làm an lòng, làm dịu đi
reliever 	(n)	 Người, thuốc làm giảm đau
religion 	(n)	 Tôn giáo, tín ngưỡng
religionism 	(n)	 Sự cuồng tín
religiosity 	(n)	 Lòng mộ đạo
religious 	(a)	 Thuộc về tôn giáo
religiously 	(adv)	 Một cách sủng bái
religiousness 	(n)	 Tôn giáo
remote 	(a)	 Xa xôi
remotely 	(adv)	 Rất mơ hồ, rất xa xôi
remoteness 	(n)	 Xự xa xôi , cách biệt
removability 	(n)	 Sự có thể di dời
removal 	(n)	 Sự lấy bỏ, dọn nhà
remove 	(v)	 Dọn đi, tẩy, xóa
removeable 	(a)	 Có thể tháo gỡ, di dời
remover 	(n)	 Người dọn nhà, thuốc tẩy
repair 	(v)	 Sửa chữa
repairable 	(a)	 Có thể sửa chữa
reparation 	(n)	 Sự sữa chữa
replace 	(v)	 Thay thế
replaceable 	(a)	 Có thể thay thế
replacement 	(n)	 Sự thay thế
report 	(v	 Tường thuật
reporter 	(n)	 Người tường thuật
represent 	(v)	 Đại diện, thay mặt
representation 	(n)	 Sự đại diện, thay mặt
representative 	(n)	 Người đại diện ,đại biểu
reputable 	(a)	 Có tiếng , nổi tiếng
reputation 	(n)	 Sự nổi tiếng, tiếng tăm
repute 	(v)	 Có tiếng , nổi tiếng
require 	(v)	 Yêu gặp , đòi hỏi
requirement 	(n)	 Sự yêu cầu, đòi hỏi
reservation 	(n)	 Đặt chỗ trước, thận trọng
reserve 	(v)	 Giành, giữ trước
reserved 	(a)	 Kín đáo, để dành
reservedly 	(adv)	 Một cách kín đáo
reservedness 	(n)	 Sự kín đáo
reside 	(v)	 Ở tại, trú tại
residence 	(n)	 Sự cư ngụ, chỗ ở
resident 	(n)	 Người dân định cư
residential 	(a)	 Thuộc về nhà ở, nơi ở
resolute 	(a)	 Quyết tâm, kiên quyết
resolution 	(n)	 Sự quyết tâm, giải quyết
resolve 	(v)	 Quyết tâm, giải quyết
resolved 	(a)	 Quả quyết, cương quyết
respirable 	(a)	 Có thể thở được
respirate 	(n)	 Khẩu trang, máy hô hấp
respiration 	(n)	 Hơi thở, sự thở, hô hấp
respiratory 	(a)	 Thuộc về hô hấp
respire 	(v)	 Hô hấp
respond 	(v)	 Trả lời, đáp lại
respondent 	(n)	 Người đáp lại
response 	(n)	 Lời đáp, câu trả lời
responsive 	(a)	 Trả lời, đáp lại
retire 	(v)	 Về hưu
retired 	(a)	 Đã nghỉ hưu
retirement 	(n)	 Sự nghỉ hưu
reunification 	(n)	 Sự thống nhất, hợp nhất lại
reunify 	(v)	 Thống nhất, hợp nhất
reusable 	(a)	 Có thể dùng lại
reuse 	(v)	 Sử dụng lại
revival 	(n)	 Sự hồi sinh
revive 	(v)	 Hồi sinh , làm sống lại
reviver 	(n)	 Người làm sống lại
revolute 	(v)	 Làm cách mạng
revolution 	(n)	 Cuộc cách mạng
revolutionary 	(a)	 Thuộc về cách mạng
revolutionism 	(n)	 Chủ nghĩa cách mạng
revolutionist 	(n)	 Nhà cách mạng
revolutionize 	(v)	 Cách mạng hóa
rich 	(a)	 Giàu
riches 	(n)	 Tài sản
richiness 	(n)	 Sự giàu có
richly 	(a)	 Giàu có
risk 	(v)	 Liều mạng, nguy hiểm
riskily 	(adv)	 Thật nguy hiểm
riskness 	(n)	 Sự liều, mạo hiểm
risky 	(a)	 Đầy nguy hiểm
rob 	(v)	 Cướp
robber 	(n)	 Kẻ cướp
robbery 	(n)	 Vụ cướp
rock 	(n)	 Đá cứng
rock 	(v)	 Đu đưa, gây sốc mạnh
rocker 	(n)	 Cái xích đu
rockery 	(n)	 Hòn non bộ
rocky 	(n)	 Cứng như đá , có đá
royal 	(a)	 Thuộc về hoàng gia
royalism 	(n)	 Chủ nghĩa bảo hoàng
royalist 	(n)	 Người theo CN bảo hoàng
royalistic 	(n)	 Bảo hoàng
royally 	(adv)	 Một cách rực rỡ, sang trọng
royalty 	(n)	 Hoàng thân, cấp bậc
run 	(n	 Chạy
runner 	(n)	 Người chạy
runny 	(n)	 Quá lỏng, dễ cháy
rural 	(a)	 Thuộc về nông thôn
ruralization 	(n)	 Sự nông thôn hóa S
ruralize 	(v)	 Nông thôn hóa
sad 	(a)	 Buồn , chán nản
sadden 	(v)	 Làm buồn
sadly 	(adv)	 Buồn bực
sadness 	(n)	 Sự buồn bực, chán nản
safe 	(a)	 An toàn
safely 	(adv)	 Thật an toàn
safety 	(n)	 Sự an toàn
sail 	(v)	 Đi biển bằng thuyền, tàu
sailer 	(n)	 Làm thuyền buồm
sailing 	(n)	 Sự đi biển
sailor 	(n)	 Thủy thủ
sale 	(n)	 Sự bán
salt 	(n)	 Muối
salted 	(a)	 Có ướp muối
salter 	(n)	 Người làm muối
salty 	(a)	 Mặn , có vị mặn
sand 	(a)	 Đổ cát
sand 	(n)	 Cát, bãi cát
sander 	(n)	 Người rải cát
sandy 	(a)	 Có cát
saparation 	(n)	 Sự phân chia, tách riêng
satisfaction 	(n)	 Sự thỏa mãn
satisfactorily 	(adv)	 Thật mãn nguyện
satisfactory 	(a)	 Mãn nguyện, vừa ý
satisfy 	(v)	 Thỏa mãn
satisfying 	(a)	 Làm vừa ý
scare 	(a)	 Sự hoảng sợ
scared 	(a)	 Sợ hãi
scheme 	(v	 Lập kế hoạch, chương trình
science 	(a)	 Khoa học
scientific 	(a)	 Thuộc về khoa học
scientifically 	(adv)	 Có khoa học
scientist 	(n)	 Nhà khoa học
scout 	(n)	 Hướng đạo sinh
scout 	(v)	 Thám thính, trinh sát
scouting 	(n)	 Việc hướng đạo
seat 	(n)	 Chỗ ngồi
second 	(a)	 Thứ nhì, hạng hai
second 	(n)	 Giây
secondary 	(a)	 Đệ nhị cấp , cấp 
secondly 	(adv)	 Thứ nhì là
select 	(v)	 Chọn lọc, tuyển chọn
selected 	(a)	 Lựa, tuyển, hảo hạng
selection 	(n)	 Sự tuyển chọn
selective 	(a)	 Có tính cách, tuyển chọn
selector 	(n)	 Người tuyển chọn
sell 	(v)	 Bán
seller 	(n)	 Người bán
separable 	(a)	 Có thể chia được được
separate 	(v)	 Phân chia, tách rời
seriouness 	(n)	 Sự nghiêm trọng
serious 	(a)	 Nghiêm trọng ,đứng đắn
seriously 	(adv)	 Thật nghiêmt rọng
shade 	(n)	 Bóng mát, bóng râm
shade 	(v)	 Che dấu, che mờ
shadiness 	(n)	 Bóng mát, bóng râm
shadow 	(n)	 Bóng râm
shadowy 	(a)	 Có bóng râm
shady 	(a)	 Có bóng râm
shape 	(n	 Hình dạng, tạo hình
shaped  		 Có hình dạng 
shop 	(n)	 Cửa hàng
shop 	(v)	 Đi mua sắm
shopman 	(n)	 Người chủ cửa hàng
shopper 	(n)	 Người mua sắm
short 	(a)	 Làm , ngắn, thấp
shortage 	(n)	 Sự thiếu thốn
shorten 	(v)	 Làm cho ngắn
shortly 	(adv)	 Thật ngắn
shpping 	(a)	 Việc đi mua sắm
sick 	(a)	 Yếu ,bệnh
sicken 	(v)	 Cảm thấy bệnh
sickly 	(a)	 Hay bệnh
sickness 	(n)	 Sự bệnh
sight 	(n)	 Danh lam thắng cảnh
sight 	(v)	 Thấy, trông thấy
sighted  		 Có thể nhìn được ≠ không
sightly 	(a)	 Đẹp mắt, trông dễ thương
sightseeing 	(n)	 Sự tham quan, du ngoạn
sightseer 	(n)	 Khách du lịch
silence 	(n)	 Sự im lặng
silent 	(a)	 Im lặng
silently 	(adv)	 Thật im lặng
silliness 	(n)	 Sự ngu khờ
silly 	(a)	 Ngu khờ, dại dột
similar 	(a)	 Tương tự
similarity 	(n)	 Sự tương tự
similarly 	(adv)	 Tương tự
simple 	(a)	 Đơn giản
simplicity 	(n)	 Sự đơn giản
simplification 	(n)	 Sự làm cho đơn giản
simplify 	(v)	 Làm cho đơn giản
simply 	(adv)	 Thật đơn giản
sing 	(v)	 Hát ca
singer 	(n)	 Ca sĩ
sit 	(v)	 Ngồi
situate 	(v)	 Đặt, để, đặt vào hoàn cảnh
situated 	(a)	 Được định vị ở
situation 	(n)	 Hoàn cảnh , vị trí
skeptic 	(n)	 Người hay hoài nghi
skepticial 	(a)	 Hoài nghi, không tin
skepticism 	(n)	 Chủ nghĩa hoài nghi
skiful 	(a)	 Khéo tay, tài giỏi
skifully 	(adv)	 Thật khéo léo 
skill 	(n)	 Khéo tay, kỹ năng
sleep 	(v)	 Ngủ
sleeper 	(n)	 Người ngủ
sleepily 	(adv)	 Ngủ li bì
sleepiness 	(n)	 Sự buồn ngủ
sleeping 	(n)	 Sự ngủ, giấc ngủ
sleepless 	(a)	 Mất ngủ
sleeplessly 	(adv)	 Mất ngủ
sleepy 	(a)	 Giấc ngủ
sleeve 	(n)	 Tay áo
sleeved 	(a)	 Có tay áo
sleeveless 	(a)	 Áo không tay
slight 	(a)	 Nhẹ, mỏng manh, yếu đuối
slightly 	(adv)	 Nhỏ , nhẹ, không đáng kể
slightness 	(n)	 Sự mong manh , yếu ớt, nhẹ
slow 	(a	 Chậm chạp, làm chậm
slowly 	(adv)	 Thật chậm chạp
slowness 	(n)	 Sự chậm
snout 	(n)	 Cái mõm, miệng ống
snouted 	(a)	 Có mõm, có ống tiếp vào
snow 	(n)	 Tuyết
snow 	(v)	 Tuyết rơi
snowball 	(n)	 Banh tuyết
snowman 	(n)	 Người tuyết
snowy 	(a)	 Có tuyết rơi
soak 	(v	 Thấm, nhúng, tẩm
soaked 	(a)	 Bị ước hoàn toàn
soakge 	(a)	 Sự thấm vào, nước thấm
sociability  		 Tính hợp quần , xã giao
sociable 	(a)	 Có tính xã giao thân mật
sociably 	(adv)	 Có tinh thần xã hội, hợp quầ
social 	(a)	 Thuộc về xã hội
socialism 	(n)	 Chủ nghĩa xã hội
socialist 	(n)	 Người theo chủ nghĩa
socialization 	(n)	 Sự xã hội hóa
socialize 	(v)	 Giao tiếp, xã giáo, XH hóa
socially 	(adv)	 Qua sự giao tiếp xã hội
society 	(n)	 Xã hội, giao tiếp
soft 	(a)	 Mềm dẻo
soften 	(v)	 Làm cho mềm
softener 	(n)	 Thuốc thuộc da
softly 	(adv)	 Nhẹ nhàng, êm ái
softness 	(n)	 Tính mềm dẻo
softy 	(n)	 Nhu nhược, mềm yếu
soil 	(n)	 Đất
soil 	(v)	 Làm bẩn
soiled 	(a)	 Bẩn
soiless 	(a)	 Không có vết bẩn
solar 	(a)	 Thuộc về hệ mặt trời
solar 	(energy)	 (a) (năng lượng ) mặt trời
solaria 	(plural)	 (n) Nhà kính tắm nắng
solarium 	(n)	 Nhà kính tắm nắng
solarize 	(v)	 Phơi ngoài nắng
song 	(n)	 Bài ca
sorrily 	(adv)	 Thật phiền muộn, hối hận
sorriness 	(n)	 Sự buồn rầu
sorry 	(a)	 Buồn, phiền muộn, hối hận
south 	(n	 Hướng nam, phía nam
southerly 	(a	 Gió thổi từ phía nam
southern 	(a)	 Miềm nam
southerner 	(n)	 Người dân miền nam
space 	(n	 Khoảng rộng
spacial 	(a)	 Thuộc về không gian
spacing 	(n)	 Khoảng cách giữa  vật
spacious 	(n)	 Rộng rãi, rộng chỗ
spaciously 	(adv)	 Mênh mông, rộng chỗ
spaciousness 	(n)	 Tính rộng rãi
spark 	(n	 Tóc lửa, tia lửa
sparkeling 	(a)	 Lấp lánh, sáng chói
sparking 	(n)	 Sự bắn ra những tia sáng
sparkle 	(v)	 Lắp sáng, phát ra tia sáng
sparkler 	(n)	 Vật phát sáng ,kim cương
sparklet 	(n)	 Tia lửa nhỏ
speak 	(v)	 Nói
speakable 	(a)	 Có thể nói được
speaker 	(n)	 Người nói
speaking 	(n)	 Sự nói
special 	(a)	 Đặc biệt, riêng biệt
special 	(a)	 Đặc biệt, riêng biệt
specialize 	(v)	 Chuyên biệt
specially 	(adv)	 Đặc biệt, riêng biệt
specific 	(a)	 Riêng biệt , đặc biệt
specifically 	(adv)	 Thật cụ thể
specificity 	(n)	 Nét đặt trưng , riêng biệt
speech 	(n)	 Cuộc nói chuyện
splendid 	(a)	 Lộng lẫy
splendidly 	(adv)	 Thật lộng lẫy
splendor 	(n)	 Sự lộng ẫy
spoil 	(v)	 Làm hỏng
spoilable 	(a)	 Có thể hư hỏng
spoilage 	(n)	 Sự hư hỏng
sport 	(n)	 Thể thao
sportsman 	(n)	 Nhà thể thao
sporty 	(a)	 Có tính thể thao
spray 	(v)	 Phun, xịt thuốc
sprayer 	(n)	 Bình xịt, người xịt
spraying 	(n)	 Xự phun xịt thuốc
sprotsmanship 	(n)	 Tinh thần thể thao
staion 	(n)	 Trạm, bến, nhà ga
staionary 	(a)	 Đứng yên không động đậy
standard 	(n)	 Tiêu chuẩn , mẫu mực
standardization 	(n)	 Sự tiêu chuẩn hóa
standardize 	(v)	 Làm đúng tiêu chuẩn
station 	(v)	 Đã đến nơi, đóng quân
stationer 	(n)	 Người bán văn phòng phẩm
stationery 	(n)	 Đồ dùng văn phòng phẩm
steam 	(v	 Hấp nấu, hơi nước
steamer 	(n)	 Tàu hơi nước, nồi hấp
steamy 	(a)	 Có hơi nước
sterile 	(a)	 Hiếm, khô khan, vô trùng
sterility 	(n)	 Tính vô sinh
sterilization 	(n)	 Sự tiệt trùng
sterilize 	(v)	 Tiệt trùng ,làm vô sinh
sterilizer 	(n)	 Máy khử trùng
stick 	(v)	 Cắm vào, làm dính , dính
stickily 	(adv)	 Có tính dẻo, dính
sticky 	(a)	 Dính, dẻo dai
stiker 	(n)	 Nhãn hiệu
stomach 	(n)	 Dạ dày, bao tử
stomachache 	(n)	 Cơn đau dạ dày
storm 	(a	 Giông tố, mưa, bão
stormily 	(adv)	 Thật ồ ạt, mưa , bão
storminess 	(n)	 Sự ào ạt
stormy 	(a)	 Thuộc về mưa bão, ào ạt
straigh 	(a)	 Thẳng hàng, ngay thẳng
straighten 	(v)	 Kéo cho thẳng ra
straightening 	(ness)	 (n) Sự thẳng , thẳng
strain 	(n)	 Sức căng thẳng
strain 	(v)	 Kéo căng ra, làm căng
strained 	(a)	 Cũng thẳng
strange 	(a)	 Lạ
strangely 	(adv)	 Thật lạ lùng
strangeness 	(n)	 Sự lạ lùng
stranger 	(v)	 Người lạ
strength 	(n)	 Sự mạnh mẽ
strengthen 	(v)	 Làm cho mạnh
stretch 	(v	 Kéo dài, sự kéo căng ra
stretcher 	(n)	 Vật để căng, khung căng
stretchiness 	(n)	 Tính căng
stretchy 	(a)	 Co giãn, căng
strict 	(a)	 Nghiêm khắc
strictly 	(adv)	 Thật nghiêm khắc
strictness 	(n)	 Sự nghiêm khắc
stripe 	(v	 Kẻ sọc, đường sọc
striped 	(a)	 Có sọc
strong 	(a)	 Mạnh mẽ
strongly 	(adv)	 Thật mạnh mẽ
struggle 	(v	 Cuộc đấu tranh , chiến đấu
struggling 	(a)	 Đấu tranh , vật lộn
stumble 	(v	 Vấp ngã , trượt
stumbling 	(a)	 Vấp, trượt chân
succeed 	(v)	 Thành công
success 	(n)	 Sự thành công
successful 	(a)	 Thành công
successfully 	(adv)	 Thật thành công
sudden 	(a)	 Thình lình, đột xuất
suddeness 	(n)	 Sự bất tình lình
suddenly 	(adv)	 Bất tình lình
suffer 	(v)	 Chịu đựng ,đau khổ
sufferable 	(a)	 Có thể chịu được
sufferamce 	(n)	 Sự nhẫn nại, chịu đựng
sufferer 	(n)	 Người chịu đau khổ, nạn nhân
suffering 	(n)	 Sự đau đớn, buồn phiền
sugar 	(v	 Đường, bỏ đường
sugariness 	(n)	 Tính chất ngọt
sugary 	(a)	 Có nhiều đường, như đường
suggest 	(v)	 Đề nghị, khuyên can
suggestion 	(n)	 Sự gợi ý, đề nghị
suggestive 	(a)	 Có vẻ gợi ý
suit 	(v)	 Làm cho thích hợp
suitableness  		 Sự thích hợp
suitably 	(adv)	 Thích hợp
sun 	(n)	 Mặt trời
sunbath 	(n)	 Sự phơi nắng, tắm nắng
sunbathe 	(v)	 Tắm nắng
sunny 	(a)	 Có nắng
support 	(v)	 ủng hộ, giúp đỡ, chịu đựng
supportable 	(a)	 Có thể chịu được
supporter 	(n)	 Người ủng hộ
supportive 	(a)	 Có lòng giúp đỡ
sure 	(a)	 Chắc chắn
sureness 	(n)	 Sự chắc chắn
surfer 	(adv)	 Thật chắc chắn
surprise 	(a	 Ngạc nhiên
surprised 	(at)	 (a) Bị làm ngạc nhiên
surprisedlly 	(adv)	 Thật đáng ngạc nhiên
surprising 	(a)	 Ngạc nhiên
surprisingly 	(adv)	 Thật ngạc nhiên
swallow 	(v	 Nuốt, tiêu thụ
swallowable 	(a)	 Có thể nuốt
swim 	(v)	 Bơi lội
swimmer 	(n)	 Người bơi lội
swimming 	(n)	 Môn bơi
symbol 	(n)	 Biểu tượng
symbolical 	(a)	 Có tính tượng trưng
symbolics 	(n)	 Biểu tượng (số nhiều)
symbolism 	(n)	 Chủ nghĩa biểu tượng
symbolist 	(n)	 Người theo CN biểu tượng
symbolize 	(v)	 Tượng trưng
talent 	(n)	 Tài năng
talented 	(a)	 Có tài
talentless 	(a)	 Bất tài
tall 	(a)	 Cao (dùng cho người )
taste 	(n	 Vị, nếm
tasteful 	(a)	 Có óc thẩm mỹ
tastefully 	(adv)	 Thật có thẩm mỹ
teach 	(v)	 Dạy
teacher 	(n)	 Giáo viên
teaching 	(n)	 Nghề dạy học
teaspoon 	(n)	 Thìa uống trà
teaspoonful 	(n)	 Đầy thìa uống trà
tech 	(n)	 Trường kỹ thuật
technic 	(n)	 Ngành kỹ thuật
technical 	(a)	 Thuộc về kỹ thuật
technicality 	(n)	 Tính chuyên môn kỹ thuật
technically 	(adv)	 Về mặt kỹ thuật
technician  		 Nhà kỹ thuật
technique 	(n)	 Phương pháp kỹ thuật
technology 	(n)	 Kỹ thuật học
teenage 	(a)	 Thuộc về tuổi  – 
teenaged 	(a)	 Trong độ tuổi  – 
teenager 	(n)	 Thiếu niên, thiếu nữ
teens 	(n)	 Tuổi thanh xuân
tell 	(v)	 Nói, kể
tellable 	(a)	 Có thể kể được
teller 	(n)	 Người nói, người hay kể
telling 	(n)	 Câu chuyện kể lại
temperance 	(n)	 Sự điều độ, chừng mực
temperate 	(a)	 Điều độ, chừng mực
temperately 	(adv)	 Một cách chừng mực
temperature 	(n)	 Nhiệt độ
terribly 	(adv)	 Thật khủng khiếp
terrific 	(a)	 Ghê sợ, cực kỳ
terrifically 	(adv)	 Cực kỳ, hết sức
terrified 	(a)	 Cảm thấy sợ
terrify 	(v)	 Làm cho sợ
terrile 	(a)	 Khủng khiếp, khiếp sợ
thank 	(v)	 Cảm ơn, lời cảm ơn
thankful 	(a)	 Biết ơn
thankfully 	(adv)	 Đầy lòng biết ơn
thankfulness 	(n)	 Sự biết ơn, lòng cảm tạ
thankgivings 	(n)	 Lễ tạ ơn
thankless 	(a)	 Vô ơn
thanklessly 	(adv)	 Thật vô ơn
thick 	(a)	 Dày
thicken 	(v)	 Làm cho dày thêm
thickish 	(a)	 Hơi dày
thickly 	(adv)	 Thật dày
thickness 	(n)	 Sự dày đặc
thights 	(n)	 Quần áo ôm sát (số nhiều )
thin 	(a)	 Mỏng , ốm
thin 	(v)	 Làm mỏng, cán mỏng
think 	(v)	 Suy nghĩ
thinker 	(n)	 Người suy nghĩ
thinly 	(adv)	 Thật mỏng manh
thinner 	(a)	 Mỏng hơn
thinness 	(n)	 Tính mỏng manh
thinnish 	(a)	 Hơi mỏng
third 	(a	 Thứ ba, người, vật thứ 
thirdly 	(adv)	 Thứ ba là
thirst 	(n)	 Sự khát nước
thirstily 	(adv)	 Khoa khát
thirstry 	(a)	 Khát nước
thoughtful 	(a)	 Có suy nghĩ
thoughtfully 	(adv)	 Thận trọng
three 	(a)	 Số ba
tidal 	(a)	 Thuộc về con nước thủy triều
tide 	(n)	 Dòng nước , thủy triều
tide 	(v)	 Cuốn đi
tideless 	(a)	 Không có thủy triều
tideway 	(n)	 Kênh lạch thủy triều chạy
tidily 	(adv)	 Thật ngăn nắp
tidiness 	(n)	 Sự gọn gàng
tidy 	(a	 Gọn gàng, ngăn nắp
tight 	(a)	 Khít , chặt, bó sát
tighten 	(v)	 Làm chặ, bó lại
tightly 	(adv)	 Thật khít, bó
tightness 	(n)	 Sự kín, chặt chẽ
tire 	(v)	 Làm hco mệt
tired 	(a)	 Mệt,buồn chán
tiredness  		 Sự mệt nhọc
tolerable 	(a)	 Có thể tha thứ được
tolerably 	(adv)	 Kha khá, vừa vừa
tolerance 	(n)	 Lòng khoan dung, tha thứ
tolerant 	(a)	 Khoan chung , tha thứ
tolerate 	(v)	 Chịu đựng, tha thứ
tooth 	(n)	 Cái răng
torist 	(n)	 Khách đi du lịch
total 	(a	 Toàn thể, tổng cộng
totalisty 	(n)	 Toàn bộ, tổng số
totalization 	(n)	 Sự cộng lại, tổng cộng
totalizator  		 Người hoặc máy cộng
totalize 	(v)	 Cộng lại, góp lại
totally 	(adv)	 Toàn bộ
tour 	(n)	 Cuộc hành trình , du lịch
tour 	(v)	 Đi du lịch vòng quanh
tourism 	(n)	 Ngành du lịch
touristic 	(a)	 Thuộc về du lịch
touristy 	(a)	 Hấp dẫn khách du lịch
tradition 	(n)	 Truyền thống
traditional 	(a)	 Thuộc về truyền thống
traditionalize 	(v)	 Biến thành truyền thống
traditionally 	(adv)	 Một cách truyền thống
traffic 	(n)	 Giao thông , đi lại
traffic cop 	cop	 Cảnh sát giao thông
traffic jam 	jam	 Nạn kẹt xe
traffic light 	light	 Đèn giao thông
trafficator 	(n)	 Đèn Signal
trafficker 	(n)	 Thương gia
tragedian 	(n)	 Diễn viên bi kịch (nam)
tragedienne 	(n)	 Diễn viên bi kịch (nữ)
tragedy 	(n)	 Bi kịch, bi thảm
tragic  		 Bi kịch,bi thảm
tragically 	(adv)	 Thật bi thảm
transit 	(v	 Vận chuyên, chuyên chở, đi
transition 	(n)	 Sự chuyển tiếp, quá độ
translate 	(v)	 Dịch, phiên dịch
translation 	(n)	 Bài dịch
translator 	(n)	 Phiên dịch viên
trasitduty 	(n)	 Thuế hải quan
trasitional 	(a)	 Chuyển tiếp
travel 	(v	 Du hành, đi xa
traveled 	(a)	 Đã đi nhiều
traveler 	(n)	 Khách du lịch
traveling 	(a)	 Thuộc về du lịch, dời chỗ
tribal 	(a)	 Thuộc về bộ lạc
tribalism 	(n)	 Hệ thống bộ lạc
tribe 	(n)	 Bộ lạc, bộ tộc
tribesman 	(n)	 Người trong bộ tộc
tropic 	(n)	 Chí tuyến, vùng nhiệt đới
tropical 	(a)	 Thuộc về vùng nhiệt đới
tropically 	(adv)	 Có tính cách nhiệt đới
trudy 	(adv)	 Thực sự đúng
true 	(a)	 Đúng
trust 	(n	 Lòng tin, tiến nhiệm
trusted 	(a)	 Có thể tin cậy được
trustee 	(n)	 Người được ủy thác
trustfully 	(adv)	 Đầy tin tưởng, sẵn lòng tin
trustiness 	(n)	 Trung thành, đáng tin cậy
trustless 	(a)	 Thiếu chân thật
trusty 	(a)	 Đáng tin cậy
truth 	(n)	 Sự thật
truthful 	(a)	 Chân thật
truthfully 	(adv)	 Thật chân thật
tumble 	(n)	 Sự nhào lộn, lộn xộn
tumble 	(v)	 Ngã lăn, đổ xuống , làm té
tumbler 	(n)	 Diễn viên nhào lộn
tumbling 	(n)	 Môn nhào lộn ,rơi xuống
tyically 	(adv)	 Thật tiêu biểu
type 	(v)	 Đánh máy
typewriter 	(n)	 Máy đánh chủ U
typical 	(a)	 Tiêu biểu, điển hình
typification 	(n)	 Sự làm điển hình
typify 	(n)	 Làm mẫu cho ai
typist 	(n)	 Người đánh máy
umplug 	(v)	 Tháo rời, rút ra
unbulllon 	(n)	 Không cài nút C
understand 	(n)	 Hiểu biết
understandable 	(a)	 Có thể hiểu được
understanding 	(n	 Sự hiểu biết
unfortunate 	(a)	 Bất hạnh, không may mắn
unfortunately 	(adv)	 Thật không may mắn
unhealthful 	(a)	 Không có lợi cho sức khỏe
unhealthfully 	(adv)	 Thật không có lợi cho sức khỏe
unhealthily 	(adv)	 Thật yếu đuối
unhealthy 	(a)	 Yếu đuối, không khỏe
unimportant 	(a)	 Không quan trọng
unique 	(a)	 Độc nhất, vô song
uniquely 	(adv)	 Độc đáo, duy nhất
uniqueness 	(n)	 Sự độc nhất
unluckily 	(adv)	 Không may mắn
unlucky 	(a)	 Không may mắn
unncessarily 	(adv)	 Thật không cần thiết
unnecessary 	(a)	 Không cần thiết
unpleasant 	(a)	 Bực mình, khó chịu
unpleasantly 	(adv)	 Thật bực mình
unpleasantness 	(n)	 Sự bực mình
unplugged 	(a)	 Được tháo rời, rút ra
unreal 	(a)	 Không thật
unsuccessful 	(a)	 Không thành công
unsuitable 	(a)	 Không phù hợp, bất lực
unsuitableness 	(n)	 Sự bất tài
unsuitably 	(adv)	 Thật bất tài
unsure 	(a)	 Không chắc chắn
unusal 	(a)	 Không thường lệ
upgrade 	(v)	 Nâng cấp
urban 	(a)	 Thuộc về thành thị
urbanism 	(n)	 Đô thị
urbanization 	(n)	 Sự đô thị hóa
urbanize 	(v)	 Đô thị hóa
use 	(n)	 Dùng, sử dụng
useful 	(v)	 Hữu dụng
usefully 	(adv)	 Rất hữu dụng
useless 	(a)	 Vô dụng
usual 	(a)	 Thường, quen
usually 	(adv)	 Thông thường, thường lệ
valuable 	(a)	 Có giá trị
valuation 	(n)	 Giá trị, sự đánh giá
valuator  		 Người định giá
value 	(n	 Giá trị, định giá
valueless 	(a)	 Không giá trị
variety 	(n)	 Sự đa dạng
various 	(a)	 Khác nhau
variously 	(adv)	 Khác nhau
vary 	(v)	 Làm đa dạng
vegetarian 	(a)	 Chay, ăn chay
vegetarian 	(n)	 Người ăn chay
vegetarianism 	(n)	 Chế độ ăn chay
vienamese 	(a)	 Thuộc về Việt Nam
vietnam 	(n)	 Nước Việt Nam
vietnamese 	(n)	 Người Việt Nam, tiếng Việt
view 	(n	 Nhìn, tầm nhìn
viewer 	(n)	 Người xem TV
viewless 	(a)	 Không nhìn thấy
village 	(n)	 Làng xã
villager 	(n)	 Dân làng
violence 	(n)	 Sự mãnh liệt
violent 	(a)	 Mạnh mẽ, dự dội
violently 	(adv)	 Thật mãnh liệt, bạo lực
voluntarily 	(adv)	 Một cách tình nguyện
voluntariness 	(n)	 Tính tình nguyện W
voluntary 	(a)	 Tình nguyện, xung phong
volunteer 	(v	 Người tình nguyện, tình nguyện
wait 	(v)	 Đợi chờ
waiter 	(n)	 Người hầu
wander 	(v	 Đi lang thang , sự đi thơ thẩn
wandere 	(n)	 Người hay thú đi lang thang
wandering 	(n)	 Sự đi lang thang, lạc hướng
warm 	(a	 Ấm áp, hâm nóng
warmly 	(adv)	 Thật ấm áp
warmness 	(n)	 Sự ấm áp
waste 	(v)	 Lãng phí
wasteful 	(a)	 Lãng phí
wastefully 	(adv)	 Thật lãng phí
weak 	(a)	 Yếu ớt, yếu đuối
weaken 	(v)	 Làm yếu đi
weakish 	(a)	 Hơi yếu
weakly 	(adv)	 Thật yếu ớt
weakness 	(n)	 Sự yếu ớt
wear 	(v	 Mặc đồ, sự mặc
wearable 	(a)	 Có thể mang mặc được
week 	(n)	 Tuần lễ
weekly 	(a)	 Hàng tuần
weigh 	(v)	 Cân nặng
weight 	(n)	 Sức nặng, trọng lượng
weight 	(v)	 Cân nặng
well 	(adv)	 Tốt, giỏi
well 	(adv)	 Tốt, khỏe
west 	(a	 Hướng tây, miền tây
wester 	(v)	 Xoay về hướng tây
westerly 	(adv)	 Về hướng tây
western 	(a)	 Phương tây
westerner 	(n)	 Người phương tây
westernize 	(v)	 Tây phương hóa
wet 	(a)	 ẩm ướt
wetness 	(n)	 Tình trạng ẩm ướt
white 	(a)	 Trắng
whiten 	(v)	 Làm trắng , tẩy trắng
whitenese 	(n)	 Sự trắng, trong trắng
whitening 	(n)	 Sự làm cho trắng
wide 	(a)	 Rộng rãi
widely 	(adv)	 Thật rộng rãi
widen 	(v)	 Làm cho rộng, mở rộng
widening 	(n)	 Sự mở rộng
wight 	(n)	 Sức nặng, trọng lượng
willingly 	(adv)	 Thật sẵn lòng
willingness 	(n)	 Sự tự nguyện
willling 	(n)	 Sẵn lòng
win 	(v)	 Chiến thắng
wind 	(n	 Gió, gió thổi
windless 	(a)	 Không có gió
windy 	(a)	 Có gió
winner 	(n)	 Người chiến thắng
winning 	(a)	 Thắng cuộc
winnings 	(n)	 Tiền ăn cá độ , trúng thưởng
wisdom 	(n)	 Trí thông minh, trí khôn
wise 	(a)	 Khôn ngoan , thông thái
wise 	(v)	 Khôn ra, hiểu hơn
wisely 	(adv)	 Thật khôn ngoan
wonder 	(n	 Điều kỳ diệu, làm lạ
wonderful 	(a)	 Tuyệt vời
wonderfully 	(adv)	 Thật tuyệt vời
wood 	(n)	 Gỗ, rừng
wooded 	(a)	 Có nhiều cây
wooden 	(v)	 Làm bằng gỗ, đần độn
woodenly 	(adv)	 Thật đần độn
work 	(v	 Làm việc, công việc
worker 	(n)	 Công nhân
worried 	(a)	 Bị làm cho lo lắng
worry 	(n	 Lo lắng
worrying 	(n)	 Nhiều lo lắng
worship 	(v)	 Thờ cúng, kính trọng, tôn thờ
worshiper 	(n)	 Người tôn sùng, kính trọng
worshipful 	(a)	 Tôn sùng, kính trọng
worth 	(n)	 Đáng giá, xứng đáng
worthily 	(adv)	 Thật xứng đáng, có giá trị
worthiness 	(n)	 Giá trị, xứng đáng
worthless 	(a)	 Không giá trị
worthy 	(a)	 Xứng đáng
wound 	(v	 Làm bị thương, vết thương
woundable 	(a)	 Dễ bị tổn thương
wounded 	(a)	 Đã bị tổn thương, người bị thương
wrap 	(n)	 Áo choàng, vải bọc ngoài
wrap 	(v)	 Gói , bao bọc
wrapper 	(n)	 Người gói, vải, giấy gói
wrapping 	(n)	 Bao bì, sự gói bao bọc
write 	(v)	 Viết
writer 	(n)	 Người viết, nhà văn
writing 	(n)	 Bài viết
wrong 	(a	 Sai , lỗi lầm
wrongful 	(a)	 Lầm lỗi, trái luật, bất công
wrongfully 	(adv)	 Một cách nhầm lẫn, sai trái
wrongly 	(adv)	 Một cái sai lầm , bất công
year 	(n)	 Năm
yearly 	(a)	 Hằng năm
yougish 	(a)	 Khá trẻ
young 	(a)	 Trẻ
youngster 	(n)	 Người thanh niên, thanh nữ
youth 	(n)	 Thanh niên
youthful 	(a)	 Tuổi trẻ, con nít
youthfully 	(adv)	 Như con nít
